于淑恩	于議員淑恩																	
于樹潔	于議員樹潔																	
于靜華	于議員靜華																	
于寶彥	于議員寶彥																	
尤水得	尤議員水得																	
方信淵	方議員信淵	方信淵議員	議員方信淵															
方啟榮	方議員啟榮																	
方緒縈	方議員緒縈																	
方錫淇	方議員錫淇																	
王力員	王議員力員																	
王天恩	王議員天恩																	
王文玉	王議員文玉																	
王文金	王議員文金																	
王木森	王議員木森																	
王正經	王議員正經																	
王玉雲	王議員玉雲																	
王石定	王議員石定																	
王如志	王議員如志																	
王志桓	王議員志桓																	
王志雄	王議員志雄																	
王爭	王議員爭																	
王金雄	王議員金雄																	
王金源	王議員金源																	
王青	王議員青																	
王俊男	王議員俊男																	
王春德	王議員春德																	
王炳水	王議員炳水																	
王振玉	王議員振玉																	
王書川	王議員書川																	
王啟聰	王議員啟聰																	
王清佐	王議員清佐																	
王清泉	王議員清泉																	
王清茂	王議員清茂																	
王清連	王議員清連																	
王清絡	王議員清絡																	
王連生	王議員連生																	
王惠民	王議員惠民																	
王登山	王議員登山																	
王貴人	王議員貴人																	
王進財	王議員進財																	
王進瑞	王議員進瑞																	
王隆遜	王議員隆遜																	
王義利	王議員義利																	
王義雄	王議員義雄																	
王聖仁	王議員聖仁	王聖仁議員	議員王聖仁															
王榮仁	王議員榮仁																	
王慧玲	王議員慧玲																	
王樂羲	王議員樂羲																	
王龍生	王議員龍生																	
王翼風	王議員翼風																	
王麗花	王議員麗花																	
王耀裕	王議員耀裕	王耀裕議員	議員王耀裕															
王齡嬌	王議員齡嬌																	
王櫻燕	王議員櫻燕																	
包煥壽	包議員煥壽																	
史景星	史議員景星																	
史萬忠	史議員萬忠																	
石迴川	石議員迴川																	
伊斯坦大	伊斯坦大‧貝雅夫‧正福	伊斯坦大貝雅夫正福	伊斯坦大議員	伊斯坦大議員貝雅夫正福	伊斯坦大．貝雅夫．正福	伊斯坦大‧貝雅夫‧正福議員												
安世琪	安議員世琪																	
朱子石	朱議員子石																	
朱文慶	朱議員文慶																	
朱仙和	朱議員仙和																	
朱再發	朱議員再發																	
朱安雄	朱議員安雄	朱議長安雄																
朱有福	朱議員有福																	
朱金龍	朱議員金龍																	
朱信強	朱議員信強	朱信強議員	議員朱信強															
朱星羽	朱議員星羽																	
朱春煦	朱議員春煦																	
朱挺玗	朱議員挺玗																	
朱挺珊	朱議員挺珊																	
朱萬成	朱議員萬成																	
朱銅樹	朱議員銅樹																	
江吉源	江議員吉源																	
江玲君	江議員玲君																	
江英次	江議員英次																	
江振陸	江議員振陸																	
江健一	江議員健一																	
江晚來	江議員晚來																	
江瑞鴻	江議員瑞鴻	江瑞鴻議員	議員江瑞鴻															
西文廣	西議員文廣																	
何玉淑	何議員玉淑																	
何生春	何議員生春																	
何保長	何議員保長																	
何堅心	何議員堅心																	
何清	何議員清																	
何勝雄	何議員勝雄																	
何景得	何議員景得																	
何湊川	何議員湊川																	
何錦昌	何議員錦昌																	
何權峰	何議員權峰	何權峰議員	議員何權峰	菊系何權峰														
余正助	余議員正助																	
余清行	余議員清行																	
余聲欽	余議員聲欽																	
余耀波	余議員耀波																	
吳丁福	吳議員丁福																	
吳文生	吳議員文生																	
吳文耀	吳議員文耀																	
吳比	吳議員比																	
吳正成	吳議員正成																	
吳正隆	吳議員正隆																	
吳石楠	吳議員石楠																	
吳光誠	吳議員光誠																	
吳老枝	吳議員老枝																	
吳利成	吳議員利成	吳利成議員	議員吳利成															
吳秀雄	吳議員秀雄																	
吳見草	吳議員見草																	
吳尚卿	吳議員尚卿	吳議長尚卿																
吳承璋	吳議員承璋																	
吳林淑敏	吳林議員淑敏																	
吳俊志	吳議員俊志																	
吳南洋	吳議員南洋																	
吳建德	吳議員建德																	
吳政勳	吳議員政勳																	
吳春雄	吳議員春雄																	
吳昱輝	吳議員昱輝																	
吳美澄	吳議員美澄																	
吳重新	吳議員重新																	
吳珠惠	吳議員珠惠	吳議長珠惠																
吳益串	吳議員益串																	
吳益政	吳議員益政	吳益政議員	議員吳益政	吳益正														
吳素鳳	吳議員素鳳																	
吳國雄	吳議員國雄																	
吳崇恒	吳議員崇恒																	
吳崇桓	吳議員崇桓																	
吳敏雄	吳議員敏雄																	
吳清秀	吳議員清秀																	
吳陳惠珍	吳陳議員惠珍																	
吳敦義	吳敦義市長	吳市長敦義	吳揆	吳敦義前院長														
吳登樹	吳議員登樹																	
吳瑞泰	吳議員瑞泰																	
吳榮堂	吳議員榮堂																	
吳熙祖	吳議員熙祖																	
吳銘賜	吳議員銘賜	吳銘賜議員	議員吳銘賜															
吳德美	吳議員德美																	
吳震豐	吳議員震豐																	
吳鴻鳴	吳議員鴻鳴																	
吳鐘靈	吳議員鐘靈	吳鐘靈議長	吳議長鐘靈															
吳蘭珍	吳議員蘭珍																	
吳鶴松	吳議員鶴松	吳議長鶴松	吳鶴松議長															
呂一平	呂議員一平																	
呂天良	呂議員天良																	
呂振福	呂議員振福																	
呂錦龍	呂議員錦龍																	
宋石	宋議員石																	
宋立彬	宋議員立彬	宋立彬議員	議員宋立彬															
宋長治	宋議員長治																	
宋傳彥	宋議員傳彥																	
宋萬春	宋議員萬春																	
巫火財	巫議員火財																	
巫秋炳	巫議員秋炳																	
李文良	李議員文良																	
李文興	李議員文興																	
李永南	李議員永南																	
李玉章	李議員玉章																	
李在	李議員在																	
李存敬	李議員存敬																	
李亞築	李議員亞築	李亞築議員	議員李亞築															
李亞頻	李議員亞頻																	
李往	李議員往																	
李昆澤	李議員昆澤	李昆澤委員	李委員昆澤	李昆澤立法委員														
李明郎	李議員明郎																	
李明雄	李議員明雄																	
李金川	李議員金川																	
李金祿	李議員金祿																	
李長生	李議員長生	李長生議員	議員李長生															
李雨庭	李雨庭議員	李議員雨庭	議員李雨庭															
李柏毅	李議員柏毅	李柏毅議員	議員李柏毅															
李炳森	李議員炳森																	
李眉蓁	李議員眉蓁	李眉蓁議員	議員李眉蓁															
李祈良	李議員祈良																	
李致毅	李議員致毅																	
李庭飛	李議員庭飛																	
李通如	李議員通如																	
李陳玉盞	李陳議員玉盞																	
李喬如	李議員喬如	李喬如議員	議員李喬如															
李復興	李議員復興																	
李朝觔	李議員朝觔																	
李紫雲	李議員紫雲																	
李進旺	李議員進旺																	
李開鳳	李議員開鳳																	
李雅芬	李議員雅芬	李雅芬議員	議員李雅芬															
李雅慧	李議員雅慧	李雅慧議員	議員李雅慧															
李雅靜	李議員雅靜	李雅靜議員	議員李雅靜															
李雲廷	李議員雲廷																	
李順進	李議員順進	李順進議員	議員李順進															
李順德	李議員順德																	
李源棧	李議員源棧																	
李嘉俊	李議員嘉俊																	
李榮宗	李議員榮宗																	
李漢川	李議員漢川																	
李福連	李議員福連																	
李福蓮	李議員福蓮																	
李德康	李議員德康																	
李輝煌	李議員輝煌																	
李鋒斌	李議員鋒斌																	
李憲章	李議員憲章																	
李蕙蕙	李議員蕙蕙	李蕙蕙議員	議員李蕙蕙															
李鴻鈞	李議員鴻鈞	李鴻鈞議員	議員李鴻鈞															
汪雨辰	汪議員雨辰																	
汪修慎	汪議員修慎																	
汪順卿	汪議員順卿																	
汪德培	汪議員德培																	
汪遵謀	汪議員遵謀																	
沈孟宗	沈議員孟宗																	
沈定國	沈議員定國																	
沈英章	沈議員英章	沈英章議員	岡山本洲工業區服務中心沈主任英章	議員沈英章														
沈連登	沈議員連登																	
沈義	沈議員義																	
卓文後	卓議員文後																	
周成壁	周議員成壁																	
周成璧	周議員成璧																	
周良田	周議員良田																	
周玲妏	周議員玲妏	周玲妏議員	議員周玲妏															
周恩錫	周議員恩錫																	
周順源	周議員順源																	
周鍾湛	周鍾戰	周鍾贊	周鍾讚	周鐘湛														
周鍾?	周議員鍾?	周鍾?議員	議員周鍾?															
周鶴壽	周議員鶴壽																	
易金枝	易議員金枝																	
林丁財	林議員丁財																	
林三郎	林議員三郎																	
林于凱	林議員于凱	林于凱議員	議員林于凱	時力林于凱														
林仁和	林議員仁和																	
林天補	林議員天補																	
林天霖	林議員天霖																	
林文弘	林議員文弘																	
林仙保	林議員仙保																	
林本南	林議員本南																	
林民傑	林議員民傑	林民傑議員	議員林民傑															
林永堅	林議員永堅	林永堅副市長	林永堅議員															
林先進	林議員先進																	
林再生	林議員再生																	
林奇賓	林議員奇賓																	
林孟丹	林議員孟丹																	
林季容	林議員季容																	
林宛蓉	林議員宛蓉	林宛蓉議員	議員林宛蓉	林苑容	林菀蓉													
林宜鑑	林議員宜鑑																	
林明堂	林議員明堂																	
林武忠	林議員武忠	林武忠議員	議員林武忠															
林芳如	林議員芳如	林芳如議員	議員林芳如															
林金田	林議員金田																	
林金池	林議員金池																	
林金德	林議員金德																	
林金興	林議員金興																	
林金鐘	林議員金鐘																	
林信吉	林議員信吉																	
林建成	林議員建成																	
林建論	林議員建論																	
林洪愛玉	林洪議員愛玉																	
林英斌	林英斌局長	海洋局林局長英斌	經濟發展局林副局長英斌															
林茂雄	林議員茂雄																	
林重陽	林議員重陽																	
林峻峰	林議員峻峰																	
林振福	林議員振福																	
林旅昆	林議員旅昆																	
林商輅	林議員商輅																	
林啟濱	林議員啟濱																	
林國正	林議員國正	林國正議員	議員林國正	林國正立委														
林國權	林議員國權																	
林崎	林議員崎																	
林崑山	林議員崑山																	
林崑漢	林議員崑漢																	
林御天	林議員御天																	
林添丁	林議員添丁																	
林清景	林議員清景																	
林連忠	林議員連忠																	
林連森	林議員連森																	
林魚連	林議員魚連																	
林富崙	林議員富崙																	
林富寶	林議員富寶	林富寶議員	議員林富寶															
林惠文	林議員惠文																	
林景元	林議員景元																	
林景星	林議員景星																	
林智生	林議員智生																	
林智鴻	林議員智鴻	林智鴻議員	議員林智鴻															
林朝城	林議員朝城																	
林朝英	林議員朝英																	
林絲娛	林絲瑜																	
林進慧	林議員進慧																	
林新海	林議員新海																	
林源山	林議員源山																	
林祺瑞	林議員祺瑞																	
林祺福	林議員祺福																	
林義信	林議員義信																	
林義迪	林議員義迪	林義迪議員	議員林義迪															
林路田	林議員路田																	
林預	林議員預																	
林壽山	林議員壽山																	
林榮助	林議員榮助																	
林榮國	林議員榮國																	
林滴娟	林議員滴娟																	
林福	林議員福																	
林劉月琴	林劉議員月琴																	
林澄增	林議員澄增																	
林瑩蓉	林議員瑩蓉	林瑩蓉議員	議員林瑩蓉	林瑩容														
林鬧長	林議員鬧長																	
林黎琤	林議員黎琤																	
林濃生	林議員濃生																	
林燕務	林議員燕務																	
林錫珪	林議員錫珪																	
林錫逢	林議員錫逢																	
林鍚逢	林議員鍚逢																	
林瓊瑤	林議員瓊瑤																	
林麟星	林議員麟星																	
邱于軒	邱議員于軒	邱于軒議員	議員邱于軒															
邱俊憲	邱議員俊憲	邱俊憲議員	議員邱俊憲															
邱春?	邱議員春?																	
邱高妹	邱議員高妹																	
邱清江	邱議員清江																	
邱智生	邱議員智生																	
邱義生	邱議員義生																	
邱道得	邱議員道得																	
邱潘秀春	邱潘議員秀春																	
邱潤銀	邱議員潤銀																	
侯神保	侯議員神保																	
姚慶芳	姚議員慶芳																	
姚頤良	姚議員頤良																	
施天來	施議員天來																	
施鐘?	施議員鐘?																	
柯玉淑	柯議員玉淑																	
柯悟	柯議員悟																	
柯珠美	柯議員珠美																	
柯清	柯議員清																	
柯路加	柯議員路加	柯路加議員	議員柯路加															
柯澄	柯議員澄																	
洪天盛	洪議員天盛																	
洪世海	洪議員世海																	
洪平朗	洪議員平朗	洪平朗議員	議員洪平朗															
洪兆雄	洪議員兆雄																	
洪地利	洪議員地利																	
洪吸	洪議員吸																	
洪秀錦	洪議員秀錦	洪秀錦議員	議員洪秀錦															
洪見來	洪議員見來																	
洪周金女	洪周議員金女																	
洪茂俊	洪議員茂俊																	
洪泰記	洪議員泰記																	
洪欲採	洪議員欲採																	
洪添丁	洪議員添丁																	
洪登	洪議員登																	
洪照男	洪議員照男																	
洪壽美	洪議員壽美																	
洪福緣	洪議員福緣																	
洪褔緣	洪議員褔緣																	
洪賢	洪議員賢																	
洪龍雄	洪議員龍雄																	
洪辭棻	洪議員辭棻																	
紀春財	紀議員春財																	
胡宗麟	胡議員宗麟																	
胡靜雄	胡議員靜雄																	
苗華岷	苗議員華岷																	
范水興	范議員水興																	
范姜新運	范姜議員新運																	
范瑞光	范議員瑞光																	
范錦春	范議員錦春																	
凌天送	凌議員天送																	
凌源吉	凌議員源吉																	
唐惠美	唐惠美議員	唐議員惠美	議員唐惠美															
夏標	夏議員標																	
姬文海	姬議員文海																	
孫土池	孫議員土池																	
孫太雲	孫議員太雲																	
孫祈政	孫議員祈政																	
孫茂	孫議員茂																	
孫媽狀	孫議員媽狀																	
孫媽諒	孫議員媽諒																	
孫榮吉	孫議員榮吉																	
孫慶龍	孫慶龍議員	孫議員慶龍	議員孫慶龍															
徐志明	徐議員志明																	
徐瑞桃	徐議員瑞桃																	
徐榮延	徐榮延議員	徐議員榮延	議員徐榮延															
涂瑞龍	涂議員瑞龍																	
涂劉葵妹	涂劉議員葵妹																	
祝畫澄	祝議員畫澄																	
翁有成	翁議員有成																	
翁昭福	翁議員昭福																	
翁瑞珠	翁瑞珠議員	翁議員瑞珠	翁議員瑞珠															
翁萬基	翁議員萬基																	
耿雄山	耿議員雄山																	
馬雲瑞	馬議員雲瑞																	
馬維邦	馬議員維邦																	
高文良	高議員文良																	
高玉生	高議員玉生																	
高再福	高議員再福																	
高宗英	高議員宗英																	
高明源	高議員明源																	
高信雄	高議員信雄																	
高振華	高議員振華																	
高閔琳	高閔琳議員	高議員閔琳	議員高閔琳															
高鵬飛	高議員鵬飛																	
康裕成	康裕成議長	康裕成議員	康議長裕成	康議員裕成	議長康裕成	議員康裕成	康總召裕成	康議長	康議員									
張仁石	張議員仁石																	
張文瑞	張文瑞議員	張議員文瑞	議員張文瑞															
張四正	張議員四正																	
張四英	張議員四英																	
張正信	張議員正信																	
張光雄	張議員光雄																	
張再	張議員再																	
張有卿	張議員有卿																	
張坤裕	張議員坤裕																	
張承愈	張議員承愈																	
張明白	張議員明白																	
張明昆	張議員明昆																	
張省吾	張議員省吾																	
張美瑤	張議員美瑤																	
張美麗	張議員美麗																	
張宴麟	張議員宴麟																	
張海清	張議員海清																	
張益郎	張議員益郎																	
張素惠	主計處張處長素惠	張素惠處長																
張財為	張議員財為																	
張乾德	張議員乾德																	
張啟周	張議員啟周																	
張清泉	王議員清泉	張議員清泉																
張勝富	張勝富議員	張議員勝富	議員張勝富	張總召勝富														
張喜	張議員喜																	
張番鴨	張議員番鴨																	
張順進	議員李順進																	
張媽意	張議員媽意																	
張瑞妍	張議員瑞妍																	
張瑞芙	張議員瑞芙																	
張瑞德	張議員瑞德																	
張祿壂	張議員祿壂																	
張達智	張議員達智																	
張榮昌	張議員榮昌																	
張榮顯	張議員榮顯																	
張漢忠	張漢忠議員	張議員漢忠	議員張漢忠	張漢宗														
張漢清	張議員漢清																	
張福龍	張議員福龍																	
張德戊	張議員德戊																	
張德禾	張議員德禾																	
張簡五龍	張簡議員五龍																	
張簡金	張議員簡金																	
張簡將弘	張簡議員將弘																	
張簡淦	張議員簡淦																	
張簡朝雄	張簡議員朝雄																	
張簡朝闖	張簡議員朝闖																	
張簡麗華	張簡議員麗華																	
張豐藤	張豐藤局長	張豐藤議員	張議員豐藤	環境保護局張局長豐藤	議員張豐藤													
張寶桐	張議員寶桐																	
曹明輝	曹議員明輝																	
梁文裕	梁議員文裕																	
梁調鳳	梁議員調鳳																	
梅再興	梅議員再興																	
章玟琇	章議員玟琇																	
莊士卿	莊議員士卿																	
莊文樺	莊議員文樺																	
莊高都	莊議員高都																	
莊啟旺	莊啟旺議員	莊議長啟旺	莊議員啟旺	議員莊啟旺														
莊敏次	莊議員敏次																	
莊順序	莊議員順序																	
許寸金	許議員寸金																	
許天南	許議員天南																	
許文忠	許議員文忠																	
許王朱鶯	許王議員朱鶯																	
許他海	許議員他海																	
許正雄	許議員正雄																	
許玉崑	許議員玉崑																	
許白土	許議員白土																	
許西瑞	許議員西瑞																	
許辰源	許議員辰源																	
許昆祥	許議員昆祥																	
許松標	許議員松標																	
許金煜	許議員金煜																	
許昭輝	許議員昭輝																	
許秋粽	許議員秋粽																	
許浪子	許議員浪子																	
許崑源	許崑源議長	許崑源議員	許議長崑源	許議員崑源	議長許崑源	議員許崑源												
許清陽	許議員清陽																	
許清榮	許議員清榮																	
許智傑	許委員智傑	許智傑委員	許議員智傑	許智傑立法委員														
連立堅	連立堅議員	連議員立堅	議員連立堅															
郭三平	郭議員三平																	
郭天民	郭議員天民																	
郭同全	郭議員同全																	
郭吳台巧	郭吳議員台巧																	
郭吳合巧	郭吳議員合巧																	
郭明春	郭議員明春																	
郭林彩鳳	郭林議員彩鳳																	
郭玟成	郭議員玟成																	
郭金生	郭議員金生																	
郭建盟	郭建盟議員	郭議員建盟	議員郭建盟															
郭秋塗	郭議員秋塗																	
郭真同	郭議員真同																	
郭素桃	郭議員素桃																	
郭國志	郭議員國志																	
郭國基	郭議員國基																	
郭清心	郭議員清心																	
郭順	郭議員順																	
郭新富	郭議員新富																	
郭萬枝	郭議員萬枝																	
郭壽帶	郭議員壽帶																	
郭福裕	郭議員福裕																	
郭潤銀	邱議員潤銀	郭議員潤銀																
郭獎吉	郭議員獎吉																	
陳一雄	陳議員一雄																	
陳乃靜	陳議員乃靜																	
陳之向	陳議員之向																	
陳之問	陳議員之問																	
陳文忠	陳議員文忠																	
陳水印	陳議員水印																	
陳水扁	陳水扁總統	陳總統水扁	阿扁															
陳水音	陳議員水音																	
陳水淋	陳議員水淋																	
陳水發	陳議員水發																	
陳王儷芬	陳王議員儷芬																	
陳平均	陳議員平均																	
陳戊川	陳議員戊川																	
陳正樹	陳議員正樹																	
陳玉波	陳議員玉波																	
陳生苞	陳議員生苞																	
陳田錨	陳議員田錨	陳議長田錨																
陳兆燊	陳議員兆燊																	
陳光復	陳議員光復																	
陳如東	陳議員如東																	
陳村雄	陳議員村雄																	
陳秀雄	陳議員秀雄																	
陳宗保	陳議員宗保																	
陳幸富	陳議員幸富																	
陳忠鎮	陳議員忠鎮																	
陳明仁	陳議員明仁																	
陳明吉	陳議員明吉																	
陳明看	陳議員明看																	
陳明澤	陳明澤議員	陳議員明澤	議員陳明澤															
陳明礎	陳議員明礎																	
陳東海	陳議員東海																	
陳林喜	陳議員林喜																	
陳武璋	陳議員武璋																	
陳武勳	陳議員武勳																	
陳玫娟	陳玫娟議員	陳議員玫娟	議員陳玫娟															
陳金豹	陳議員金豹																	
陳信瑜	陳信瑜議員	陳議員信瑜	議員陳信瑜															
陳宣旭	陳議員宣旭																	
陳政聞	陳政聞議員	陳議員政聞	議員陳政聞															
陳春生	陳議員春生																	
陳柏蒼	陳議員柏蒼																	
陳玲俐	陳議員玲俐																	
陳皆興	陳議員皆興																	
陳秋東	陳議員秋東																	
陳美雅	陳美雅議員	陳議員美雅	議員陳美雅															
陳致中	陳致中議員	陳議員致中	議員陳致中															
陳致富	陳議員致富																	
陳若翠	陳議員若翠																	
陳英璨	陳議員英璨																	
陳振	陳議員振																	
陳振夫	陳議員振夫																	
陳振勝	陳議員振勝																	
陳振福	陳議員振福																	
陳浴沂	陳議員浴沂																	
陳啟昱	陳副市長啟昱	陳啟昱副市長	陳議員啟昱															
陳啟清	陳議員啟清																	
陳國盛	陳議員國盛																	
陳國憲	陳議員國憲																	
陳崑崙	陳議員崑崙																	
陳得富	陳議員得富																	
陳敏生	陳議員敏生																	
陳添運	陳議員添運																	
陳清文	陳議員清文																	
陳清玉	陳議員清玉																	
陳清艾	陳議員清艾																	
陳清邦	陳議員清邦																	
陳善慧	陳議員善慧																	
陳富村	陳議員富村																	
陳景林	陳議員景林																	
陳朝成	陳議員朝成																	
陳進昌	陳議員進昌																	
陳進順	陳議員進順																	
陳雲龍	陳議員雲龍																	
陳新妥	陳議員新妥																	
陳祿存	陳議員祿存																	
陳義行	陳議員義行																	
陳義明	陳議員義明																	
陳萬海	陳議員萬海																	
陳萬富	陳議員萬富																	
陳萬達	陳議員萬達																	
陳萬壽	陳議員萬壽																	
陳道實	陳議員道實																	
陳榮昌	陳議員榮昌																	
陳滿英	陳議員滿英																	
陳漢昇	陳議員漢昇																	
陳福財	陳議員福財																	
陳粹鑾	陳粹鑾議員	陳議員粹鑾	議員陳粹鑾	陳翠鑾														
陳銀櫃	陳議員銀櫃																	
陳德祥	陳議員德祥																	
陳慧文	陳慧文議員	陳議員慧文	議員陳慧文															
陳鋕成	陳議員鋕成																	
陳龍河	陳議員龍河																	
陳濤	陳議員濤																	
陳聰敏	陳議員聰敏																	
陳麗珍	陳麗珍議員	陳議員麗珍	議員陳麗珍															
陳麗娜	陳麗娜議員	陳議員麗娜	議員陳麗娜															
陳騰雲	陳議員騰雲																	
陸來福	陸議員來福																	
陸性融	陸議員性融																	
陸淑美	陸淑美議員	陸議員淑美	議員陸淑美	陸副議長淑美														
陸雲皆	陸議員雲皆																	
傅玉祥	傅議員玉祥																	
傅林美惠	傅林議員美惠																	
傅森明	傅議員森明																	
彭林芳	彭議員林芳																	
彭清靠	彭議員清靠																	
曾丁成	曾議員丁成																	
曾仁春	曾議員仁春																	
曾文生	曾文生局長	經濟發展局曾局長文生																
曾水文	曾水文議員	曾議員水文	議員曾水文															
曾玉清	曾議員玉清																	
曾宗鏞	曾議員宗鏞																	
曾宗鏡	曾議員宗鏡																	
曾長發	曾議員長發																	
曾俊傑	曾俊傑議員	曾議員俊傑	議員曾俊傑															
曾昭山	曾議員昭山																	
曾炳琳	曾議員炳琳																	
曾炳煌	曾議員炳煌																	
曾晚吉	曾議員晚吉																	
曾祥	曾議員祥																	
曾傃東	曾議員傃東																	
曾榮仁	曾議員榮仁																	
曾福三	曾議員福三																	
曾麗燕	曾麗燕議員	曾議員麗燕	議員曾麗燕															
游陳秋香	游陳議員秋香																	
湯金全	湯議員金全																	
湯阿根	湯議員阿根																	
程洙	程議員洙																	
程培弘	程議員培弘																	
程進添	程議員進添																	
童燕珍	童燕珍議員	童議員燕珍	議員童燕珍															
華加納	華議員加納																	
華國良	華議員國良																	
華清吉	華議員清吉																	
馮國華	馮議員國華																	
黃八亦	黃議員八亦																	
黃八野	黃議員八野																	
黃五湖	黃議員五湖																	
黃天煌	黃天煌議員	黃議員天煌	議員黃天煌															
黃文志	黃議員文志																	
黃文益	黃議員文益																	
黃文章	黃議員文章																	
黃世界	黃議員世界																	
黃世英	黃議員世英																	
黃世源	黃議員世源																	
黃丙子	黃議員丙子																	
黃北全	黃議員北全																	
黃占岸	黃議員占岸																	
黃正忠	黃議員正忠																	
黃永	黃議員永																	
黃石龍	黃石龍議員	黃副議長石龍	黃議員石龍	議員黃石龍	黃石龍副議長													
黃兆呈	黃議員兆呈																	
黃再發	黃議員再發																	
黃再德	黃議員再德																	
黃有天	黃議員有天																	
黃朱灼華	黃朱議員灼華																	
黃余?鸞	黃余議員?鸞																	
黃秀男	黃議員秀男																	
黃良舜	黃議員良舜																	
黃承城	黃議員承城																	
黃明太	黃議員明太																	
黃明河	黃議員明河																	
黃河清	黃議員河清																	
黃河澄	黃議員河澄																	
黃秉文	黃議員秉文																	
黃芳仁	黃議員芳仁																	
黃昭星	黃議員昭星																	
黃昭順	黃委員昭順	黃昭順委員	黃議員昭順															
黃柏霖	黃柏霖議員	黃議員柏霖	議員黃柏霖															
黃秋?	黃議員秋?	黃秋女英	黃秋英	黃秋瑛														
黃香菽	黃香菽議員	黃議員香菽	議員黃香菽	黃香叔														
黃夏雪玉	黃夏議員雪玉																	
黃振塊	黃議員振塊																	
黃振賢	黃議員振賢																	
黃高州	黃議員高州																	
黃啟川	黃議員啟川	黃議長啟川																
黃國銘	黃議員國銘																	
黃得	黃議員得																	
黃捷	黃議員捷	黃捷議員	議員黃捷															
黃淑美	黃淑美議員	黃議員淑美	議員黃淑美															
黃淵深	黃議員淵深																	
黃添財	黃議員添財																	
黃清和	黃議員清和																	
黃清輝	黃議員清輝																	
黃紹庭	黃紹庭議員	黃議員紹庭	議員黃紹庭															
黃博紅	黃議員博紅																	
黃堯	黃議員堯																	
黃朝聰	黃議員朝聰																	
黃登丕	黃議員登丕																	
黃登勇	黃議員登勇																	
黃貴祥	黃議員貴祥																	
黃順成	黃議員順成																	
黃萬全	黃議員萬全																	
黃萬教	黃議員萬教																	
黃載德	黃議員載德																	
黃嘉源	黃議員嘉源																	
黃碧霞	黃議員碧霞																	
黃福昌	黃議員福昌																	
黃福欽	黃議員福欽																	
黃銅樹	黃議員銅樹																	
黃賜	黃議員賜																	
黃輝芳	黃議員輝芳																	
黃興招	黃議員興招																	
黃璽文	黃議員璽文																	
黃韻涵	黃蘊涵																	
黃寶源	黃議員寶源																	
黃騰華	黃議員騰華																	
楊五	楊議員五																	
楊文雄	楊議員文雄																	
楊平漢	楊議員平漢																	
楊永文	楊議員永文																	
楊兆居	楊議員兆居																	
楊合	楊議員合																	
楊色玉	楊議員色玉																	
楊見福	楊見福議員	楊議員見福	議員楊見福															
楊邦	楊議員邦																	
楊定國	楊議員定國																	
楊昆林	楊議員昆林																	
楊振添	楊議員振添																	
楊敏郎	楊議員敏郎																	
楊章明	楊議員章明																	
楊雅雲	楊議員雅雲																	
楊?	楊議員?																	
楊萬與	楊議員萬與																	
楊萬興	楊議員萬興																	
楊劉香	楊劉議員香																	
楊魏美枝	楊魏議員美枝																	
溫慕春	溫議員慕春																	
萬周月娥	萬周議員月娥																	
葉月容	葉議員月容																	
葉月蓉	葉議員月蓉																	
葉李月理	葉李議員月理																	
葉金冶	葉議員金冶																	
葉阿綿	葉議員阿綿																	
葉津鈴	葉議員津鈴																	
葉香	葉議員香																	
葉登祺	葉議員登祺																	
葉發欉	葉議員發欉																	
葉進國	葉議員進國																	
葉順隆	葉議員順隆																	
葉福安	葉議員福安																	
葉寶山	葉議員寶山																	
葛賢	葛議員賢																	
董廷良	董議員廷良																	
董貞治	董議員貞治																	
董進財	董議員進財																	
董新詮	董議員新詮																	
董錦樹	董議員錦樹																	
詹永龍	詹議員永龍																	
詹金福	詹議員金福																	
賈先德	賈議員先德																	
廖正雄	廖議員正雄																	
管碧玲	管委員碧玲	管碧玲委員	管碧玲立法委員															
趙天麟	趙天麟委員	趙委員天麟	趙議員天麟	趙天麟立法委員														
趙善標	趙議員善標																	
趙樹寰	趙議員樹寰																	
劉化南	劉議員化南																	
劉天杏	劉議員天杏																	
劉少春	劉議員少春																	
劉文雄	劉議員文雄																	
劉文禧	劉議員文禧																	
劉日昇	劉議員日昇																	
劉木錠	劉議員木錠																	
劉水胖	劉議員水胖																	
劉玉麟	劉議員玉麟																	
劉先譜	劉議員先譜																	
劉安紅	劉議員安紅																	
劉扶源	劉議員扶源																	
劉昌博	劉議員昌博																	
劉武雄	劉議員武雄																	
劉英裕	劉議員英裕																	
劉茂德	劉議員茂德																	
劉振村	劉議員振村																	
劉貴郎	劉議員貴郎																	
劉進興	研究發展考核委員會劉主任委員進興	劉進興主任委員	劉進興主委															
劉義興	劉議員義興																	
劉葆德	劉議員葆德																	
劉達景	劉議員達景																	
劉誌來	劉議員誌來																	
劉德林	劉德林議員	劉議員德林	議員劉德林															
劉燕輝	劉議員燕輝																	
劉興杰	劉議員興杰																	
劉龍泉	劉議員龍泉																	
劉馨正	劉議員馨正	劉馨正議員	議員劉馨正															
樓啟文	樓議員啟文																	
歐石秀	歐議員石秀																	
歐春總	歐議員春總																	
潘三義	潘議員三義																	
潘有諒	潘議員有諒																	
潘作宏	潘議員作宏																	
潘家欽	潘議員家欽																	
蔡天送	蔡議員天送																	
蔡天從	蔡議員天從																	
蔡文玉	蔡議員文玉																	
蔡文?	蔡議員文?																	
蔡文賓	蔡議員文賓																	
蔡生後	蔡議員生後																	
蔡李美靈	蔡李議員美靈																	
蔡見興	蔡議長見興	蔡議員見興																
蔡受	蔡議員受																	
蔡坤山	蔡議員坤山																	
蔡坤木	蔡議員坤木																	
蔡昌男	蔡議員昌男																	
蔡昌達	副議長蔡昌達	蔡昌達副議長	蔡昌達議員	蔡副議長昌達	蔡議員昌達	議員蔡昌達												
蔡明耀	蔡議員明耀																	
蔡松雄	蔡副議長松雄	蔡議員松雄																
蔡武宏	蔡議員武宏																	
蔡武男	蔡議員武男																	
蔡芳男	蔡議員芳男																	
蔡金水	蔡議員金水																	
蔡金治	蔡議員金治																	
蔡金晏	蔡金晏議員	蔡議員金晏	議員蔡金晏															
蔡長根	蔡議員長根																	
蔡建生	蔡議員建生																	
蔡津村	蔡議員津村																	
蔡旅濱	蔡議員旅濱																	
蔡祟禮	蔡議員祟禮																	
蔡崇禮	蔡議員崇禮																	
蔡彩宏	蔡議員彩宏																	
蔡清國	蔡議員清國																	
蔡景軾	蔡議員景軾																	
蔡發欉	蔡議員發欉																	
蔡媽福	蔡議員媽福																	
蔡億建	蔡議員億建																	
蔡寬永	蔡議員寬永																	
蔡寬興	蔡議員寬興																	
蔡慶源	蔡議員慶源																	
蔡錦峻	蔡議員錦峻																	
蔡龍居	蔡龍居副局長	蔡議員龍居	衛生局蔡副局長龍居															
蔡簡美雪	蔡議員簡美雪																	
蔡麗珠	蔡議員麗珠																	
蔡讚	蔡議員讚																	
蔣金聰	蔣議員金聰																	
賢繼禹	賢議員繼禹																	
鄧武二	鄧議員武二																	
鄭中雄	鄭議員中雄																	
鄭心忠	鄭議員心忠																	
鄭水池	鄭議員水池																	
鄭光峰	鄭光峰議員	鄭議員光峰	議員鄭光峰	市議員鄭光峰														
鄭安秝	鄭議員安秝																	
鄭李惠	鄭議員李惠																	
鄭良男	鄭議員良男																	
鄭來成	鄭議員來成																	
鄭孟洳	鄭議員孟洳																	
鄭明岳	鄭議員明岳																	
鄭明進	鄭議員明進																	
鄭金標	鄭議員金標																	
鄭清榮	鄭議員清榮																	
鄭復華	鄭議員復華																	
鄭復臨	鄭議員復臨																	
鄭黃素美	鄭議員黃素美																	
鄭新助	鄭新助議員	鄭議員新助	議員鄭新助															
鄭綿	鄭議員綿																	
鄭增祥	鄭議員增祥																	
盧中義	盧議員中義																	
盧文英	盧議員文英																	
盧伯濬	盧議員伯濬																	
盧伯濱	盧議員伯濱	蘆議員伯濱																
盧謝珊珊	盧謝議員珊珊																	
盧繼竇	盧議員繼竇																	
蕭子真	蕭議員子真																	
蕭王平	蕭議員王平																	
蕭永達	蕭永達議員	蕭議員永達	議員蕭永達															
蕭育穎	蕭議員育穎																	
蕭見義	蕭議員見義																	
蕭金蘭	蕭議員金蘭																	
蕭華銘	蕭議員華銘																	
蕭裕正	蕭議員裕正																	
賴文德	賴議員文德	賴文德議員	議員賴文德															
賴瑞隆	海洋局賴局長瑞隆	新聞局賴局長瑞隆	賴瑞隆局長	賴瑞隆委員	賴瑞隆立法委員	菊系賴瑞隆												
錢長受	錢議員長受																	
錢俊瑋	錢議員俊瑋																	
錢俊皞	錢議員俊皞																	
錢聖武	錢聖武議員	錢議員聖武	議員錢聖武															
錢夢明	錢議員夢明																	
駱榮金	駱議員榮金																	
戴良慶	戴議員良慶																	
戴雨蒼	戴議員雨蒼																	
戴添貴	戴議員添貴																	
戴進吉	戴議員進吉																	
戴德銘	戴議員德銘																	
薛成風	薛議員成風																	
薛來進	薛議員來進																	
薛俊櫻	薛議員俊櫻																	
謝友華	謝議員友華																	
謝兆南	謝議員兆南																	
謝有用	謝議員有用																	
謝志富	謝議員志富																	
謝垂耀	謝議員垂耀																	
謝春正	謝議員春正																	
謝張梅子	謝張議員梅子																	
謝清忠	謝議員清忠																	
謝清標	謝議員清標																	
謝貴來	謝議員貴來																	
謝進炎	謝議員進炎																	
謝瑞民	謝議員瑞民																	
謝萬福	謝議員萬福																	
鍾宗廟	鍾議員宗廟																	
鍾易仲	鍾議員易仲																	
鍾飛昌	鍾議員飛昌																	
鍾泰山	鍾議員泰山																	
鍾啟元	鍾議員啟元																	
鍾盛有	鍾盛有議員	鍾議員盛有	議員鍾盛有															
鍾鳳祥	鍾議員鳳祥																	
鍾德珍	鍾議員德珍																	
鍾藏欽	鍾議員藏欽																	
韓國瑜	韓市長國瑜	韓國瑜市長																
韓連吉	韓議員連吉																	
韓賜村	韓賜村議員	韓議員賜村	議員韓賜村	市議員韓賜村														
歸順義	歸議員順義																	
簡金城	簡議員金城																	
簡海源	簡議員海源																	
簡益章	簡議員益章																	
簡煥宗	簡煥宗議員	簡議員煥宗	議員簡煥宗															
藍建菖	藍議員建菖																	
藍星木	藍星木議員	藍議員星木	議員藍星木															
藍家鼎	藍議員家鼎																	
藍振源	藍議員振源																	
藍高祥	藍議員高祥																	
藍健菖	海洋局藍局長健菖	經濟發展局藍局長健菖	藍健菖局長	藍健菖議員	藍議員健菖													
藍國徵	藍議員國徵																	
顏文章	顏議員文章																	
顏火山	顏議員火山																	
顏進寶	顏議員進寶																	
顏曉菁	顏曉菁議員	顏議員曉菁	議員顏曉菁															
顏寶琴	顏議員寶琴																	
羅兆洪	羅議員兆洪																	
羅志明	羅議員志明																	
羅鼎城	羅鼎城議員	羅議員鼎城	議員羅鼎城															
羅德順	羅議員德順																	
蘇文良	蘇議員文良																	
蘇文禎	蘇議員文禎																	
蘇文德	蘇議員文德																	
蘇文慶	蘇議員文慶																	
蘇玉柱	蘇議員玉柱																	
蘇守成	蘇議員守成																	
蘇吳賴	蘇議員吳賴																	
蘇明江	蘇議員明江																	
蘇杰	蘇議員杰																	
蘇法	蘇議員法																	
蘇炎城	蘇炎城議員	蘇議員炎城	議員蘇炎城															
蘇員	蘇議員員																	
蘇惠珍	蘇議員惠珍																	
蘇琦莉	蘇琦莉議員	蘇議員琦莉	議員蘇琦莉															
蘇慶芬	蘇議員慶芬																	
鐘元	鐘議員元																	
鐘同加	鐘議員同加																	
鐘啟蒸	鐘議員啟蒸																	
鐘紹恢	鐘議員紹恢																	
龔睿宏	龔議員睿宏																	
龔遜霖	龔議員遜霖																	
丁允恭	丁允恭局長	丁局長允恭	新聞局丁局長允恭															
于鎮慆	于鎮慆大隊長	交通警察大隊于大隊長鎮慆																
孔賢傑	孔主任秘書賢傑	孔賢傑主任秘書																
尤天厚	尤天厚主任秘書	法制局尤主任秘書天厚																
尹立	尹立局長	文化局尹局長立																
王世芳	王世芳代理局長	法制局王代理局長世芳																
王啟川	王啟川局長	都市發展局王局長啟川																
王國材	王國材局長	交通局王局長國材																
王進安	王進安總經理	高雄銀行王總經理進安																
王進焱	王進焱副局長	教育局王副局長進焱																
王端仁	王端仁局長	海洋局王局長端仁																
古秀妃	古秀妃主任委員	古秀妃主委	客家事務委員會古主任委員秀妃															
史哲	史哲副市長	史副市長哲	文化局史局長哲															
何明洲	何明洲局長	警察局何局長明洲																
何啟功	何啟功局長	衛生局何局長啟功																
余潮駿	工務局違章建築處理大隊余大隊長潮駿	余潮駿大隊長																
吳宏謀	市政府吳秘書長宏謀	吳宏謀副市長	吳副市長宏謀															
吳明昌	吳明昌處長	養護工程處吳處長明昌																
吳英明	吳英明校長	吳校長英明																
吳家安	中區資源回收廠吳廠長家安	吳家安廠長																
吳敏達	地政局旗山地政事務所吳主任敏達	吳敏達主任																
吳瑞川	吳瑞川處長	養護工程處吳處長瑞川																
吳義隆	吳義隆代理局長	吳義隆局長	捷運工程局吳代理局長義隆	捷運工程局吳局長義隆														
宋孔慨	宋孔慨局長	宋孔慨副局長	毒品防治局宋局長孔慨	警察局宋副局長孔慨														
宋夜生	宋夜生主席	員工消費合作社宋理事主席夜生																
李永得	李永得副市長	李副市長永得																
李幸娟	李幸娟區長	鼓山區公所李區長幸娟																
李怡德	李怡德局長	都市發長局李局長怡德	經發局李局長怡德	經濟發展局李局長怡德														
李煥熏	李煥熏局長	勞工局李代理局長煥熏	勞工局李局長煥熏	勞工局李副局長煥熏														
李瑞倉	李秘書長瑞倉	李瑞倉秘書長	財政局李局長瑞倉															
李碧昭	李碧昭分局長																	
李蓮香	李蓮香校長	橋頭國中李校長蓮香																
李賢義	水利局李局長賢義	李賢義局長																
李憲偉	李憲偉分局長																	
李穆生	李穆生局長	環境保護局李局長穆生																
李瓊慧	李瓊慧處長	稅捐稽徵處李處長瓊慧																
林正立	林正立所長	林所長正立																
林合勝	林合勝處長	政風處林處長合勝																
林志東	林志東副處長	養護工程處林副處長志東																
林清益	岡山區公所林區長清益	林清益區長																
林麗英	林處長麗英	林麗英處長																
城忠志	人事處城處長忠志	城忠志處長																
姚雨靜	社會局姚局長雨靜	姚雨靜局長																
柯尚余	柯尚余局長	海洋局柯代理局長尚余	農業局柯副局長尚余															
柯芷伶	柯芷伶主任委員	柯芷伶主委	研究發展考核委員會柯主任委員芷伶															
范巽綠	范巽綠局長	教育局范局長巽綠																
范織欽	范織欽主任委員	范織欽主委	范織欽議員	范議員織欽	原住民事務委員會范主任委員織欽													
?爾敏	?爾敏處長	新建工程處?處長爾敏																
孫志鵬	孫志鵬局長	海洋局孫局長志鵬																
郝建生	郝建生秘書長	郝秘書長建生	蔡建生	蔡議員建生														
馬英九	馬英九總統	馬總統英九																
高宏上	高宏上校長	旗山國中高校長宏上																
高宗永	南區資源回收廠高廠長宗永	高宗永科長	高宗永廠長	環境保護局廢棄物管理科高科長宗永														
高鎮遠	高鎮遠副局長	經濟發展局高副局長鎮遠																
張乃千	民政局張局長乃千	社會局張局長乃千	張乃千局長															
張世傑	水利局市區排水一科張科長世傑	張世傑科長																
張家興	張家興局長	新聞局張局長家興																
張國松	張校長國松	張國松校長																
張惠博	張校長惠博	張惠博校長																
梁景淵	水利局區域排水科梁科長景淵	梁景淵科長																
許乃丹	法制局許局長乃丹	許乃丹局長																
許文瓊	許文瓊科長	勞工局科長許文瓊																
許立明	研究發展考核委員會許主任委員立明	許代理市長立明	許立明代理市長	許副市長立明	許代理市長													
許傳盛	許傳盛局長	觀光局許代理局長傳盛	觀光局許局長傳盛	許傳聖														
許瑞娟	許瑞娟副處長	養護工程處許副處長瑞娟																
許銘春	法制局許局長銘春	許副市長銘春	許銘春副市長															
許褔森	許褔森議員	許議員褔森	議員許褔森															
陳月端	法制局陳局長月端	陳月端局長																
陳世昌	大社區陳區長世昌	陳世昌區長	陳區長世昌															
陳存永	捷運工程局陳局長存永	陳存永局長																
陳居豐	陳居豐副局長	環境保護局陳副局長居豐																
陳金德	陳金德副市長	陳副市長金德	環境保護局陳局長金德															
陳冠福	土地開發處陳處長冠福	陳冠福處長																
陳勁甫	交通局陳局長勁甫	陳勁甫局長																
陳虹龍	消防局陳局長虹龍	陳虹龍局長																
陳家欽	陳家欽局長	警察局陳局長家欽																
陳淑芳	民政局陳副局長淑芳	陳淑芳副局長																
陳盛山	陳盛山局長	觀光局陳局長盛山																
陳琳樺	陳琳樺代理局長	環境保護局陳代理局長琳樺																
陳菊	陳市長菊	陳菊市長	花媽	菊姊	菊姐	菊姐仔												
陳榮周	政風處陳處長榮周	陳榮周處長																
陳賓華	兵役局陳代理局長賓華	兵役局陳局長賓華	陳賓華局長															
陳鴻益	水利局陳代理局長鴻益	陳鴻益代理局長																
陳瓊華	秘書處陳處長瓊華	陳瓊華處長																
曾姿雯	民政局曾局長姿雯	曾姿雯局長	觀光局曾局長姿雯															
曾美妙	財政局曾副局長美妙	曾美妙副局長																
曾慶崇	法制局曾局長慶崇	曾慶崇局長																
曾慶章	曾慶章分局長																	
黃文煦	黃文煦隊長	環境保護局三民東區清潔隊黃隊長文煦																
黃志中	黃志中局長	衛生局黃局長志中																
黃志明	工務局建築管理處黃處長志明	黃志明處長																
黃昭輝	秘書處黃處長昭輝	黃昭輝處長																
黃柏棻	水利局行政科黃科長柏棻	黃柏棻科長																
黃茂穗	黃茂穗局長	警察局黃局長茂穗																
黃登祥	中油石化事業部黃執行長登祥	黃登祥執行長																
黃進雄	地政局黃代理局長進雄	地政局黃局長進雄	黃進雄局長															
黃萬發	交通局黃副局長萬發	黃萬發副局長																
黃圖書	黃所長圖書	黃圖書所長																
黃榮慶	工務局新建工程處黃處長榮慶	黃榮慶處長	新建工程處黃處長榮慶															
黃憲東	兵役局黃局長憲東	黃憲東局長																
楊明州	工務局楊局長明州	楊明州局長	楊明州秘書長	楊明州副市長	楊秘書長明州	楊副市長明州												
葉建良	教育局國中教育科葉科長建良	葉建良科長																
葉菊蘭	葉代理市長菊蘭	葉市長菊蘭	葉菊蘭代理市長	葉菊蘭市長														
葉瑞與	人事處葉處長瑞與	葉瑞與處長																
鄒燦陽	鄒燦陽局長	環境保護局鄒局長燦陽																
廖哲民	水利局廖副局長哲民	廖哲民副局長																
趙文男	兵役局趙局長文男	趙文男局長																
趙建喬	工務局趙局長建喬	趙建喬秘書長	趙秘書長建喬	養護工程處趙處長建喬														
趙美佐	趙美佐隊員	環境保護局三民東區清潔隊趙清潔隊員美佐																
劉世芳	劉世芳副市長	劉副市長世芳	劉委員世芳	劉世芳委員	劉世芳立法委員													
劉沿汝	教育局秘書室劉主任沿汝	劉沿汝主任																
劉鐘麟	海洋局劉簡任技正鐘麟	劉鐘麟技正																
歐秀卿	公共汽車管理處歐處長秀卿	歐秀卿處長																
蔡孟裕	蔡孟裕局長	環境保護局蔡局長孟裕																
蔡長展	工務局蔡局長長展	水利局蔡代理局長長展	水利局蔡局長長展	蔡長展局長														
蔡俊章	蔡俊章局長	警察局蔡局長俊章																
蔡英文	蔡英文總統	蔡總統英文																
蔡清華	教育局蔡局長清華	蔡清華局長																
蔡復進	農業局蔡局長復進	蔡復進局長																
鄭介松	經濟發展局鄭副局長介松	鄭介松副局長																
鄭明倫	衛生局鄭副局長明倫	鄭明倫副局長																
鄭明興	鄭明興處長	殯葬管理處鄭處長明興																
鄭素玲	勞工局鄭局長素玲	鄭素玲局長																
鄭清山	南區資源回收廠鄭代理廠長清山	鄭清山代理廠長																
鄭清福	農業局鄭局長清福	鄭清福局長																
鄭新輝	教有局鄭局長新輝	鄭新輝局長																
鄭福儀	兵役局鄭副局長福儀	鄭福儀副局長																
盧維屏	都市發展局盧局長維屏	盧維屏局長																
謝惠卿	研究發展考核委員會謝代理主任委員惠卿	謝惠卿代理主任委員	謝惠卿代理主委															
謝福來	地政局謝局長福來	謝福來局長																
謝鶴琳	美濃區公所謝區長鶴琳	謝鶴琳區長																
鍾孔炤	勞工局鍾局長孔炤	鍾孔炤局長																
韓榮華	水利局韓代理局長榮華	韓榮華代理局長																
簡振澄	簡振澄局長	財政局簡局長振澄																
魏屏華	教育局體育及衛生保健科魏專員屏華	魏屏華專員																
蘇志勳	工務局蘇副局長志勳	新建工程處蘇代理處長志勳	新建工程處蘇處長志勳	蘇志勳副局長														
蘇麗瓊	蘇麗瓊局長	社會局蘇局長麗瓊																
鐘萬順	工務局鐘代理局長萬順	工務局鐘副局長萬順	鐘萬順代理局長	鐘萬順副局長														
謝長廷	謝長廷市長	謝市長長廷																
王金平	王院長金平	王金平委員																
陳其邁	陳代理市長其邁	陳其邁代理市長	陳其邁委員	陳委員其邁														
邱議瑩	邱委員議瑩	邱議瑩委員	邱議瑩立法委員															
邱志偉	邱志偉委員	邱委員志偉	邱志偉委員	邱委員志偉	邱志偉立法委員													
林岱樺	林岱樺委員	林委員岱樺	林岱華															
陳英燦	陳議員英燦																	
楊金虎	楊市長金虎																	
陳啟川	陳市長啟川																	
謝掙強	謝市長掙強																	
陳保泰	陳市長保泰																	
俄鄧	俄鄧殷艾	俄鄧‧殷艾	俄鄧‧殷艾議員	俄鄧殷艾議員	俄鄧議員	俄鄧．殷艾	俄鄧議員殷艾											
劉翔	劉市長翔																	
黃仲圖	黃市長仲圖																	
連謀	連市長謀																	
楊金欉	楊市長金欉																	
許水德	許市長水德																	
蘇南成	蘇市長南成																	
李登輝	李總統登輝	李登輝總統																
年金改革	年改																	
民政委員會	內政委員會																	
警消衛環委員會	衛生環境委員會	保安委員會																
衛生環境委員會	衛環委員會																	
警消衛環部門	衛生環境部門																	
衛生環境部門	衛環部門																	
震南案	震南	震南鐵線																
大陸委員會	陸委會																	
中央銀行	央行																	
科技部	國科會																	
國家發展委員會	國發會																	
教育部	教部																	
衛生福利部	衛福部																	
環境保護署	環保署																	
世大運	世界大學運動會	世大運動會																
台泥開發案	台泥案																	
縣市合併	99年縣市合併																	
慶富案	慶富聯貸案	慶富聯貸弊案	慶富獵雷艦案	慶富獵雷艦弊案	慶富獵雷艦聯貸案													
慶富	慶富公司	慶富造船	慶富造船廠	慶富集團														
高雄氣爆	81氣爆	七三一氣爆	七三一高雄氣爆	731氣爆	81氣爆事件	七三一石化氣爆事件	八一氣爆	石化氣爆	石化氣爆事件	李長榮化工氣爆案	高雄七三一石化氣爆	高雄八一氣爆	高雄市氣爆事件	高雄氣爆事件	高雄氣爆案			
美麗島事件	美麗島民主事件																	
南星計畫	大林蒲南星計畫	大林蒲南星計畫區	大南星計畫															
亞太城市高峰會	亞太城市高峰會議																	
二三讀會	二三讀																	
二、三讀會紀錄	二三讀會紀錄																	
公報	公報初稿																	
定期大會	定期會	定期會時間	定期大會時間	議會定期大會														
高雄市市有財產自治條例	市有財產自治條例																	
高雄市加強建築物公共安全管理自治條例	公共安全管理自治條例																	
高雄市市有財產開發基金收支管理及運用自治條例	財產開發基金收支管理及運用自治條例草案																	
氣候變遷小組	議會氣候變遷小組																	
高雄市公民投票自治條例	公民投票	公投																
高雄市食品安全衛生管理自治條例	食品安全管理自治條例	食安自治條例	食安條例	食安管理自治條例	食品安全衛生自治條例	食品安全衛生管理自治條例	高市食品安全衛生管理自治條例	高雄市食品安全管理自治條例										
高雄市房屋稅徵收自治條例	房屋稅自治條例																	
高雄市事業氣候變遷調適費徵收自治條例	事業氣候調適費徵收自治條例	高雄市徵收氣候變遷調適費自治條例																
高雄市污水下水道使用費徵收自治條例	污水下水道使用費收費自治條例	污水下水道使用費徵收自治條例	污水下水道徵收自治條例															
高雄市市有財產管理自治條例	市有財產自治條例	財產管理自治條例	高雄市國有財產自治條例															
高雄市既有工業管線管理自治條例	工業管線管理自治條例	既有工業管線管理自治條例	高雄市既有工業管線自治條例	工業管線自治條例	既有工業管線自治條例	既有工業管線維護管理自治條例	既有管線管理自治條例	高市工業管線管理自治條例	高市府既有工業管線管理自治條例	高雄市既有工業管線自治管理條例	高雄市既有工業管線管理自治管理條例	高雄市既有管線自治條例	高雄市既有管線管理自治條例	高雄市管線自治條例	高雄石化管線自治條例	高雄既有管線自治條例	管線自治條例	管線條例
高雄市攤販臨時集中場管理自治條例	臨時集中場管理自治條例																	
高雄市環境維護管理自治條例	高雄市環境管理自治條例	高市環境維護管理自治條例	高雄市環境管理維護自治條例	高雄市環境維護管制自治條例	高雄市環境維護管理條例	環境維護自治條例	環境維護管理自治條例	環境維護管理條例										
高雄市道路挖掘管理自治條例草案	道路挖掘自治條例	道路挖掘管理自治條例																
高雄市地方總預算案	總預算案																	
高雄市新草衙地區土地處理自治條例	高雄市新草衙地區土地管理自治條例																	
高雄市野生動物保育自治條例	野生動物保育自治條例																	
高雄市動物保護自治條例	動保自治條例	高市動物保護自治條例	動物保護自治條例	動物保護條例	動保條例													
高雄市政府組織自治條例	組織自治條例																	
高雄市議會	市議會	高市議會	巿議會	台灣高雄市市議會	高雄議會	高議會												
高雄市議會組織自治條例	高雄市議會編制表	高雄市議會組織編制表	高雄市議會組織規程	高雄市議會組織員額編制表	議會組織自治條例													
高雄市道路挖掘管理自治條例	道路挖掘管理自治條例	道路挖掘自治條例	高雄市道路挖掘管理自治條例草案															
高雄市攤販管理自治條例	高雄市攤販自治條例	攤販管理自治條例																
國民黨團	議會國民黨團																	
國民外交促進會	議會國民外交促進會																	
議長盃桌球賽	議長杯桌球																	
姊妹會	姐妹會	議會姐妹會																
個人資料保護法	個資法	資訊保護法																
高雄市政府公務人力發展中心	人發中心	人力發展中心	人事處人發中心															
大東文化藝術中心	大東文化藝術園區	鳳山大東文化藝術園區																
日月光	日月光公司	日月光半導體	日月光集團	日月光半導體公司														
中央信託局公務人員保險處	中央信託保險處																	
中央公園	高雄中央公園																	
民主進步黨	民進黨	台灣民進黨																
中國國民黨	國民黨																	
國民黨	中國國民黨																	
民進黨團	議會民進黨團																	
車輛行車事故鑑定委員會	車禍鑑定委員會	肇事鑑定委員會	鑑定委員會															
田寮區公所	田寮公所																	
家庭暴力及性侵害防治中心	家暴性侵中心																	
高雄市政府	巿政府																	
高雄市兵役處	兵役局	高雄市政府兵役局																
高雄市立聯合醫院	市立聯合醫院																	
高雄市立歷史博物館	文化局史博館	市立歷史博物館	高雄歷史博物館	歷史博物館														
高雄市立旗津醫院	市立旗津醫院	高雄市旗津醫院	高雄旗津醫院															
高雄市立凱旋醫院	凱旋醫院																	
高雄市立美術館	市立美術館	美術館	高美館	高雄市鼓山區美術館	高雄美術館	鼓山美術館												
高雄市立社會教育館	小港社教館	高雄社教館																
高雄市立民生醫院	台灣省立高雄醫院	市立民生醫院	民生醫院	高雄市民生醫院	高雄民生醫院													
高雄市立中醫醫院	市立中醫醫院																	
高雄巿立圖書館	高市圖																	
高雄市政府勞工局勞工教育生活中心	高雄市勞工局勞教中心	勞工局勞工教育生活中心																
財政部高雄市國稅局	高雄市國稅局																	
海洋文化及流行音樂中心	海洋文化流行音樂中心	海洋文化音樂中心	海洋文化暨流行音樂中心	海洋文化與流行音樂中心	海洋暨音樂流行中心	海音中心												
時代力量	時力																	
高雄流行音樂中心	流行音樂館	流行音樂中心	海洋流行文化中心	海洋文化及流行音樂中心	流音中心	高雄海洋及流行音樂中心												
高雄市立三民高級家事商業職業學校	三民家商	高雄市立三民家事商業職業學校																
高雄市立六龜高級中學	六龜高中																	
高雄市立路竹高級中學	路竹高中																	
高雄市立福誠高級中學	福誠高中																	
高雄市立林園高級中學	林園高中																	
高雄市立楠梓高級中學	楠梓高中																	
高雄市立新興高級中學	新興高中																	
高雄市立鼓山高級中學	鼓山高中																	
高雄市立瑞祥高級中學	瑞祥高中																	
高雄市立新莊高級中學	新莊高中																	
高雄市立高雄高級商業職業學校	高雄高商	高雄商業學校																
高雄市立高雄高級中學	高雄中學	台灣省立高雄第一中學																
高雄市立高雄高級工業職業學校	高雄高工																	
高雄市立高雄女子高級中學	高雄市立高雄女子中學	雄女	高雄女中															
高雄市立海青高級工商職業學校	海青工商																	
高雄市立前鎮高級中學	前鎮高中																	
高雄市立空中大學	空中大學	空大	市立空大	市立空中大學	高雄空大	高雄空中大學												
高雄市立左營高級中學	左營高中																	
高雄市立文山高級中學	文山高中																	
高雄市立仁武高級中學	仁武高中																	
高雄市立中正高級中學	中正高中																	
高雄市立中正高級工業職業學校	中正高工																	
高雄市立中山高級中學	中山高中																	
高雄市立小港高級中學	小港高中																	
高雄市立三民高級中學	三民高中																	
高雄市文化中心	中正文化中心	文化中心																
高雄市公民監督公僕聯盟	公民監督公僕聯盟	高市公民監督公僕聯盟	高都盟	高雄公民監督公僕聯盟	高雄公督盟	高雄公僕監督聯盟	高督盟											
高雄市殯葬管理處	殯葬管理處	殯葬處	高雄市殯葬處	高雄殯葬管理處	殖葬管理處	覆鼎金殯葬處												
高雄市審計處	高雄審計處																	
高雄市稅捐稽徵處	高雄市稅捐處	高雄稅捐處	稅捐稽徵處															
高雄市都市計畫委員會	高雄市都市計劃委員會	高雄市都市設計委員會	高雄市都委會															
高雄市政府觀光局	高雄市觀光局	高雄觀光局																
高雄市政府警察局鹽埕分局	高雄市警察局鹽埕分局																	
高雄市政府警察局鳳山分局	高雄市鳳山分局	高雄市警察局鳳山分局																
高雄市政府警察局鼓山分局	高雄市警察局鼓山分局																	
高雄市政府警察局楠梓分局	高雄市楠梓警分局	高雄市警察局楠梓分局																
高雄市政府警察局新興分局	高雄市新興警分局																	
高雄市政府警察局湖內分局	高雄市警察局湖內分局																	
高雄市政府警察局婦幼警察隊	婦幼隊																	
高雄市政府警察局保安警察大隊	保大																	
高雄市政府警察局岡山分局	岡山警分局	岡山警察分局																
高雄市政府警察局刑事警察大隊	刑大																	
高雄市政府警察局交通警察大隊	交大	高雄市警局交通大隊																
高雄市政府警察局三民第二分局	三民二分局																	
高雄市政府警察局	警察局	巿警局	高雄市警	高雄市警局	高雄市警察局													
高雄市政府環境保護局	環保局	高雄市環局	高雄市環保局	高雄環保局														
高雄市政府衛生局	高雄市衛生局																	
高雄市政府運動發展局	運動發展局	運發局	高雄市體育局	高雄市體育處														
高雄市政府農業局	高雄農業局																	
高雄市政府資訊中心	高雄市資訊中心																	
高雄市政府經濟發展局	經發局	高雄市經發局	高雄市經濟發展局															
高雄市政府新聞局	高雄新聞局																	
高雄市政府勞工局勞動檢查處	高雄市勞動檢查處	高雄市勞檢處	勞工局勞動檢查處	勞工局勞檢處	勞動檢查處	勞檢處												
高雄市政府勞工局訓練就業中心	高雄市勞工局訓就中心	勞工局訓就中心	勞工局訓練就業中心															
高雄市政府勞工局	高雄市勞工局	高雄勞工局	勞工局	勞局														
高雄市政府都市發展局	都發局																	
高雄市政府教育局	高雄教育局																	
高雄市政府捷運工程局	捷運局	高雄市捷運局	高雄捷運工程局	高雄捷運局	捷運工程局													
高雄市政府財政局	高雄財政局																	
高雄市政府海洋局	海洋局	高雄海洋局																
高雄市政府毒品防制局	毒防局	高雄市毒品防制局																
高雄市政府政風處	市府政風處																	
高雄市政府客家事務委員會	客家事務委員會	客委會	市府客委會															
高雄市政府社會局	市府社會局	高雄社會局																
高雄市政府法制局	市府法制局																	
高雄市政府地政局鹽埕地政事務所	鹽埕地政事務所																	
高雄市政府地政局鳳山地政事務所	鳳山地政事務所																	
高雄市政府地政局旗山地政事務所	旗山地政事務所																	
高雄市政府地政局路竹地政事務所	路竹地政事務所																	
高雄市政府地政局楠梓地政事務所	楠梓地政事務所																	
高雄市政府地政局新興地政事務所	新興地政事務所																	
高雄市政府地政局美濃地政事務所	美濃地政事務所																	
高雄市政府地政局前鎮地政事務所	前鎮地政事務所																	
高雄市政府地政局岡山地政事務所	岡山地政事務所																	
高雄市政府地政局仁武地政事務所	仁武地政事務所																	
高雄市政府地政局大寮地政事務所	大寮地政事務所																	
高雄市政府地政局土地開發處	土地開發處	土開處	高雄市政府土地開發處															
高雄市政府地政局三民地政事務所	三民地政事務所																	
高雄市政府地政局	高雄地政局																	
高雄市政府交通局	高雄交通局																	
高雄市政府主計處	高雄市主計處																	
高雄市政府工務局養護工程處	養工處	高雄市養工處																
高雄市政府工務局違章建築處理大隊	違章建築處理大隊	違建處理隊	高雄市違建處理大隊	高雄市違章建築處理大隊														
高雄市政府工務局新建工程處	新工處	高雄市新工處																
高雄捷運公司	高捷公司																	
高雄區漁會	高市漁會	高雄市漁會																
高雄縣議會	高縣議會																	
高雄銀行	市銀行	高雄市銀	高雄銀	高銀														
調解委員會	調解會																	
楠梓科技園區	後勁科技園區																	
勞工博物館	勞博館																	
台灣團結聯盟	台灣團結聯盟黨	台聯																
高雄市新興區七賢國民小學	七賢國小																	
高雄市鼓山區九如國民小學	九如國小																	
高雄市小港區二苓國民小學	二苓國小																	
高雄市仁武區八卦國民小學	八卦國小																	
高雄市三民區十全國民小學	十全國小																	
高雄市三民區三民國民小學	三民國小																	
高雄市新興區大同國民小學	大同國小																	
高雄市小港區小港國民小學	小港國小																	
高雄市鼓山區中山國民小學	中山國小																	
高雄市鳳山區中山國民小學	中山國小																	
高雄市苓雅區中正國民小學	中正國小																	
高雄市鳳山區中正國民小學	中正國小																	
高雄市旗津區中洲國民小學	中洲國小																	
高雄市鳳山區五福國民小學	五福國小																	
高雄市苓雅區五權國民小學	五權國小																	
高雄市前鎮區仁愛國民小學	仁愛國小																	
高雄市鼓山區內惟國民小學	內惟國小																	
高雄市小港區太平國民小學	太平國小																	
高雄市左營區文府國民小學	文府國小																	
高雄市楠梓區加昌國民小學	加昌國小																	
高雄市楠梓區右昌國民小學	右昌國小																	
高雄市苓雅區四維國民小學	四維國小																	
高雄市左營區左營國民小學	左營國小																	
高雄市三民區正興國民小學	正興國小																	
高雄市三民區民族國民小學	民族國小																	
高雄市那瑪夏區那瑪夏區民權國民小學	民權國小																	
高雄市前鎮區民權國民小學	民權國小																	
高雄市左營區永清國民小學	永清國小																	
高雄市三民區光武國民小學	光武國小																	
高雄市前鎮區光華國民小學	光華國小																	
高雄市鹽埕區光榮國民小學	光榮國小																	
高雄市苓雅區成功國民小學	成功國小																	
高雄市茄萣區成功國民小學	成功國小																	
高雄市岡山區和平國民小學	和平國小																	
高雄市小港區坪頂國民小學	坪頂國小																	
高雄市鳳山區忠孝國民小學	忠孝國小																	
高雄市大寮區忠義國民小學	明正國小																	
高雄市左營區明德國民小學	明德國小																	
高雄市三民區東光國民小學	東光國小																	
高雄市三民區河濱國民小學	河濱國小																	
高雄市小港區青山國民小學	青山國小																	
高雄市新興區信義國民小學	信義國小																	
高雄市前金區前金國民小學	前金國小																	
高雄市前鎮區前鎮國民小學	前鎮國小																	
高雄市左營區屏山國民小學	屏山國小																	
高雄市前金區建國國民小學	建國國小																	
高雄市苓雅區苓洲國民小學	苓洲國小																	
高雄市小港區桂林國民小學	桂林國小																	
高雄市前鎮區紅毛港國民小學	海汕國小	紅毛港國小																
高雄市三民區莊敬國民小學	莊敬國小																	
高雄市楠梓區莒光國民小學	莒光國小																	
高雄市鳥松區鳥松國民小學	鳥松國小																	
高雄市苓雅區凱旋國民小學	凱旋國小																	
高雄市左營區勝利國民小學	勝利國小																	
高雄市三民區博愛國民小學	博愛國小																	
高雄市前鎮區復興國民小學	復興國小																	
高雄市楠梓區援中國民小學	援中國小																	
高雄市三民區陽明國民小學	陽明國小																	
高雄市三民區愛國國民小學	愛國國小																	
高雄市前鎮區愛群國民小學	愛群國小																	
高雄市左營區新民國民小學	新民國小																	
高雄市左營區新莊國民小學	新莊國小																	
高雄市田寮區新興國民小學	新興國小																	
高雄市新興區新興國民小學	新興國小																	
高雄市楠梓區楠梓國民小學	楠梓國小																	
高雄市前鎮區獅甲國民小學	獅甲國小																	
高雄市三民區獅湖國民小學	獅湖國小																	
高雄市前鎮區瑞祥國民小學	瑞祥國小																	
高雄市鳳山區瑞興國民小學	瑞興國小																	
高雄市前鎮區瑞豐國民小學	瑞豐國小																	
高雄市三民區鼎金國民小學	鼎金國小																	
高雄市鼓山區鼓山國民小學	鼓山國小																	
高雄市旗山區鼓山國民小學	鼓山國小																	
高雄市鼓山區鼓岩國民小學	鼓岩國小																	
高雄市鼓山區壽山國民小學	壽山國小																	
高雄市旗津區旗津國民小學	旗津國小																	
高雄市小港區漢民國民小學	漢民國小																	
高雄市苓雅區福東國民小學	福東國小																	
高雄市苓雅區福康國民小學	福康國小																	
高雄市小港區鳳林國民小學	鳳林國小																	
高雄市小港區鳳鳴國民小學	鳳鳴國小																	
高雄市前鎮區樂群國民小學	樂群國小																	
高雄市鼓山區龍華國民小學	龍華國小																	
高雄市左營區舊城國民小學	舊城國小																	
高雄市前鎮區鎮昌國民小學	鎮昌國小																	
高雄市鹽埕區鹽埕國民小學	鹽埕國小																	
高雄市仁武區灣內國民小學	灣內國小																	
高雄市楠梓區油廠國民小學	油廠國小																	
高雄市旗津區大汕國民小學	大汕國小																	
高雄市前鎮區佛公國民小學	佛公國小																	
高雄市左營區新上國民小學	新上國小																	
高雄市左營區福山國民小學	福山國小																	
高雄市楠梓區後勁國民小學	後勁國小																	
高雄市楠梓區楠陽國民小學	楠陽國小																	
高雄市小港區華山國民小學	華山國小																	
高雄市小港區港和國民小學	港和國小																	
高雄市左營區新光國民小學	新光國小																	
高雄市小港區鳳陽國民小學	鳳陽國小																	
高雄市湖內區明宗國民小學	明義國小																	
高雄市鳳山區鳳山國民小學	鳳山國小																	
高雄市鳳山區大東國民小學	大東國小																	
高雄市鳳山區曹公國民小學	曹公國小																	
高雄市鳳山區文山國民小學	文山國小																	
高雄市鳳山區五甲國民小學	五甲國小																	
高雄市鳳山區誠正國民小學	誠正國小																	
高雄市鳳山區新甲國民小學	新甲國小																	
高雄市鳳山區南成國民小學	南成國小																	
高雄市鳳山區鎮北國民小學	鎮北國小																	
高雄市鳳山區鳳西國民小學	鳳西國小																	
高雄市鳳山區文德國民小學	文德國小	文小																
高雄市鳳山區正義國民小學	正義國小																	
高雄市鳳山區福誠國民小學	福誠國小																	
高雄市鳳山區過埤國民小學	過埤國小																	
高雄市鳳山區中崙國民小學	中崙國小																	
高雄市鳳山區文華國民小學	文華國小																	
高雄市鳳山區鳳翔國民小學	鳳翔國小																	
高雄市林園區林園國民小學	林園國小																	
高雄市林園區港埔國民小學	港埔國小																	
高雄市林園區中芸國民小學	中芸國小																	
高雄市林園區汕尾國民小學	汕尾國小																	
高雄市林園區金潭國民小學	金潭國小																	
高雄市林園區王公國民小學	王公國小																	
高雄市大寮區大寮國民小學	大寮國小																	
高雄市大寮區永芳國民小學	永芳國小																	
高雄市大寮區潮寮國民小學	潮寮國小																	
高雄市大寮區昭明國民小學	昭明國小																	
高雄市鹽埕區忠孝國民小學	忠義國小																	
高雄市大寮區翁園國民小學	翁園國小																	
高雄市大寮區溪寮國民小學	溪寮國小																	
高雄市大寮區中庄國民小學	中庄國小																	
高雄市大寮區山頂國民小學	山頂國小																	
高雄市大寮區後庄國民小學	後庄國小																	
高雄市大樹區興田國民小學	興田國小																	
高雄市大樹區溪埔國民小學	溪埔國小																	
高雄市大樹區姑山國民小學	姑山國小																	
高雄市大樹區大樹國民小學	大樹國小																	
高雄市大樹區龍目國民小學	龍目國小																	
高雄市大樹區小坪國民小學	小坪國小																	
高雄市大樹區水寮國民小學	水寮國小																	
高雄市大樹區九曲國民小學	九曲國小																	
高雄市大社區嘉誠國民小學	嘉誠國小																	
高雄市大社區觀音國民小學	觀音國小																	
高雄市大社區大社國民小學	大社國小																	
高雄市路竹區大社國民小學	大社國小																	
高雄市仁武區仁武國民小學	仁武國小																	
高雄市仁武區烏林國民小學	烏林國小																	
高雄市仁武區竹後國民小學	竹後國小																	
高雄市仁武區登發國民小學	登發國小																	
高雄市鳥松區仁美國民小學	仁美國小																	
高雄市鳥松區大華國民小學	大華國小																	
高雄市岡山區岡山國民小學	岡山國小																	
高雄市岡山區前峰國民小學	前峰國小																	
高雄市岡山區嘉興國民小學	嘉興國小																	
高雄市岡山區兆湘國民小學	兆湘國小																	
高雄市岡山區後紅國民小學	後紅國小																	
高雄市岡山區竹圍國民小學	竹圍國小																	
高雄市岡山區壽天國民小學	壽天國小																	
高雄市橋頭區橋頭國民小學	橋頭國小																	
高雄市橋頭區仕隆國民小學	仕隆國小																	
高雄市橋頭區甲圍國民小學	甲圍國小																	
高雄市橋頭區五林國民小學	五林國小																	
高雄市橋頭區興糖國民小學	興糖國小																	
高雄市燕巢區安招國民小學	安招國小																	
高雄市燕巢區金山國民小學	金山國小																	
高雄市燕巢區橫山國民小學	橫山國小																	
高雄市燕巢區燕巢國民小學	燕巢國小																	
高雄市燕巢區鳳雄國民小學	鳳雄國小																	
高雄市燕巢區深水國民小學	深水國小																	
高雄市田寮區崇德國民小學	崇德國小																	
高雄市阿蓮區阿蓮國民小學	阿蓮國小																	
高雄市阿蓮區中路國民小學	中路國小																	
高雄市阿蓮區復安國民小學	復安國小																	
高雄市路竹區路竹國民小學	路竹國小																	
高雄市路竹區竹滬國民小學	竹滬國小																	
高雄市路竹區三埤國民小學	三埤國小																	
高雄市路竹區北嶺國民小學	北嶺國小																	
高雄市路竹區下坑國民小學	下坑國小																	
高雄市路竹區一甲國民小學	一甲國小																	
高雄市路竹區蔡文國民小學	蔡文國小																	
高雄市湖內區大湖國民小學	大湖國小																	
高雄市湖內區文賢國民小學	文賢國小																	
高雄市前鎮區明正國民小學	明宗國小																	
高雄市湖內區海埔國民小學	海埔國小																	
高雄市湖內區三侯國民小學	三侯國小																	
高雄市茄萣區砂崙國民小學	砂崙國小																	
高雄市茄萣區茄萣國民小學	茄萣國小																	
高雄市茄萣區興達國民小學	興達國小																	
高雄市永安區永安國民小學	永安國小																	
高雄市永安區新港國民小學	新港國小																	
高雄市永安區維新國民小學	維新國小																	
高雄市彌陀區壽齡國民小學	壽齡國小																	
高雄市彌陀區彌陀國民小學	彌陀國小																	
高雄市彌陀區南安國民小學	南安國小																	
高雄市梓官區梓官國民小學	梓官國小																	
高雄市梓官區蚵寮國民小學	蚵寮國小																	
高雄市旗山區旗山國民小學	旗山國小																	
高雄市旗山區旗尾國民小學	旗尾國小																	
高雄市旗山區圓潭國民小學	圓潭國小																	
高雄市旗山區溪洲國民小學	溪洲國小																	
高雄市旗山區嶺口國民小學	嶺口國小																	
高雄市美濃區中壇國民小學	中壇國小																	
高雄市美濃區吉東國民小學	吉東國小																	
高雄市美濃區吉洋國民小學	吉洋國小																	
高雄市美濃區東門國民小學	東門國小																	
高雄市美濃區美濃國民小學	美濃國小																	
高雄市美濃區福安國民小學	福安國小																	
高雄市美濃區廣興國民小學	廣興國小																	
高雄市美濃區龍山國民小學	龍山國小																	
高雄市美濃區龍肚國民小學	龍肚國小																	
高雄市六龜區六龜國民小學	六龜國小																	
高雄市六龜區龍興國民小學	龍興國小																	
高雄市六龜區新發國民小學	新發國小																	
高雄市六龜區新威國民小學	新威國小																	
高雄市六龜區荖濃國民小學	荖濃國小																	
高雄市六龜區寶來國民小學	寶來國小																	
高雄市甲仙區甲仙國民小學	甲仙國小																	
高雄市甲仙區寶隆國民小學	寶隆國小																	
高雄市甲仙區小林國民小學	小林國小																	
高雄市杉林區上平國民小學	上平國小																	
高雄市杉林區集來國民小學	集來國小																	
高雄市杉林區新庄國民小學	新庄國小																	
高雄市杉林區月美國民小學	月美國小																	
高雄市杉林區杉林國民小學	杉林國小																	
高雄市內門區金竹國民小學	金竹國小																	
高雄市內門區溝坪國民小學	溝坪國小																	
高雄市內門區景義國民小學	景義國小																	
高雄市內門區木柵國民小學	木柵國小																	
高雄市內門區內門國民小學	內門國小																	
高雄市內門區觀亭國民小學	觀亭國小																	
高雄市內門區西門國民小學	西門國小																	
高雄市茂林區茂林國民小學	茂林國小																	
高雄市茂林區多納國民小學	多納國小																	
高雄市桃源區樟山國民小學	樟山國小																	
高雄市桃源區桃源國民小學	桃源國小																	
高雄市桃源區寶山國民小學	寶山國小																	
高雄市桃源區興中國民小學	興中國小																	
高雄市桃源區建山國民小學	建山國小																	
高雄市那瑪夏區民生國民小學	民生國小																	
高雄市三民區河堤國民小學	河堤國小																	
高雄市小港區明義國民小學	明義國小																	
議長辦公室	議長室																	
統一夢時代購物中心	夢時代	統一夢時代																
高雄物產館	物產館																	
公托中心	公立托嬰中心	公共托育中心	公共托嬰中心															
公督盟	公民國會監督連盟	公民監督聯盟	公民國會監督聯盟	公民監督國會聯盟														
立法院	台灣國會	國會																
西青埔垃圾掩埋場	西青埔垃圾場	西青埔掩埋場																
行政院南部聯合服務中心	行政院南部行政中心	行政院南部辦事處	行政院南服中心	行政院南部中心	行政院南部服務中心													
高雄啟智學校國中部	啟智學校國中部																	
私立國際高級商工職業學校	國際工商技術學院	國際商工																
私立道明高級中學	道明中學																	
私立復華高級中學	復華中學																	
私立明誠高級中學	明誠高中																	
私立立志高級中學	立志中學																	
私立大榮高級中學	大榮高中																	
高雄醫學大學	高醫	高醫大	高雄醫學院															
國立高雄科技大學	高雄科大																	
國立高雄餐旅大學	高雄餐旅大學	高餐旅																
國立中山大學	中山大學																	
國立高雄師範大學	高雄師範大學	高師大																
國立政治大學政治系	政大政治系																	
國立政治大學	政治大學	政大																
國立台灣大學	台灣大學	台大																
高雄師範大學	高雄師大																	
私立逢甲大學	逢甲大學																	
私立東海大學	東海大學																	
高雄市立鹽埕國民中學	鹽埕國中																	
高雄市立壽山國民中學	壽山國中																	
高雄市立明華國民中學	明華國中																	
高雄市立七賢國民中學	七賢國中																	
高雄市立左營國民中學	左營國中																	
高雄市立大義國民中學	大義國中																	
高雄市立立德國民中學	立德國中																	
高雄市立龍華國民中學	龍華國中																	
高雄市立福山國民中學	福山國中																	
高雄市立文府國民中學	文府國中																	
高雄市立楠梓國民中學	楠梓國中																	
高雄市立右昌國民中學	右昌國中																	
高雄市立後勁國民中學	後勁國中																	
高雄市立國昌國民中學	國昌國中																	
高雄市立三民國民中學	三民國中																	
高雄市立鼎金國民中學	鼎金國中																	
高雄市立民族國民中學	民族國中																	
高雄市立陽明國民中學	陽明國中																	
高雄市立正興國民中學	正興國中																	
高雄市立前金國民中學	前金國中																	
高雄市立苓雅國民中學	苓雅國中																	
高雄市立五福國民中學	五福國中																	
高雄市立大仁國民中學	大仁國中																	
高雄市立英明國民中學	英明國中																	
高雄市立前鎮國民中學	前鎮國中																	
高雄市立獅甲國民中學	獅甲國中																	
高雄市立瑞豐國民中學	瑞豐國中																	
高雄市立光華國民中學	光華國中																	
高雄市立興仁國民中學	興仁國中																	
高雄市立旗津國民中學	旗津國中																	
高雄市立小港國民中學	小港國中																	
高雄市立鳳林國民中學	鳳林國中																	
高雄市立中山國民中學	中山國中																	
高雄市立明義國民中學	明義國中																	
高雄市立鳳山國民中學	鳳山國中																	
高雄市立鳳西國民中學	鳳西國中																	
高雄市立五甲國民中學	五甲國中																	
高雄市立鳳甲國民中學	鳳甲國中																	
高雄市立忠孝國民中學	忠孝國中																	
高雄市立青年國民中學	青年國中																	
高雄市立中崙國民中學	中崙國中																	
高雄市立鳳翔國民中學	鳳翔國中																	
高雄市立中芸國民中學	中芸國中																	
高雄市立大寮國民中學	大寮國中																	
高雄市立潮寮國民中學	潮寮國中																	
高雄市立中庄國民中學	中庄國中																	
高雄市立大樹國民中學	大樹國中																	
高雄市立溪埔國民中學	溪埔國中																	
高雄市立大灣國民中學	大灣國中																	
高雄市立大社國民中學	大社國中																	
高雄市立鳥松國民中學	鳥松國中																	
高雄市立岡山國民中學	岡山國中																	
高雄市立前峰國民中學	前峰國中																	
高雄市立嘉興國民中學	嘉興國中																	
高雄市立橋頭國民中學	橋頭國中																	
高雄市立燕巢國民中學	燕巢國中																	
高雄市立田寮國民中學	田寮國中																	
高雄市立一甲國民中學	一甲國中																	
高雄市立阿蓮國民中學	阿蓮國中																	
高雄市立湖內國民中學	湖內國中																	
高雄市立茄萣國民中學	茄萣國中																	
高雄市立永安國民中學	永安國中																	
高雄市立彌陀國民中學	彌陀國中																	
高雄市立梓官國民中學	梓官國中																	
高雄市立蚵寮國民中學	蚵寮國中																	
高雄市立旗山國民中學	旗山國中																	
高雄市立大洲國民中學	大洲國中																	
高雄市立圓富國民中學	圓富國中																	
高雄市立美濃國民中學	美濃國中																	
高雄市立南隆國民中學	南隆國中																	
高雄市立龍肚國民中學	龍肚國中																	
高雄市立寶來國民中學	寶來國中																	
高雄市立甲仙國民中學	甲仙國中																	
高雄市立杉林國民中學	杉林國中																	
高雄市立內門國民中學	內門國中																	
高雄市立茂林國民中學	茂林國中																	
高雄市立桃源國民中學	桃源國中																	
高雄市立那瑪夏國民中學	那瑪夏國中																	
高雄市立鼓山國民中學國中部	鼓山中學國中部																	
高雄市立明誠國民中學國中部	明誠中學國中部																	
高雄市立大榮國民中學國中部	大榮中學國中部																	
高雄市立楠梓國民中學國中部	楠梓特校國中部																	
高雄市立立志國民中學國中部	立志中學國中部																	
高雄市立新興國民中學國中部	新興中學國中部																	
高雄市立中正國民中學國中部	中正中學國中部																	
高雄市立道明國民中學國中部	道明中學國中部																	
高雄市立復華國民中學國中部	復華中學國中部																	
高雄市立瑞祥國民中學國中部	瑞祥中學國中部																	
高雄市立福誠國民中學國中部	福誠中學國中部																	
高雄市立正義國民中學國中部	正義中學國中部																	
高雄市立林園國民中學國中部	林園中學國中部																	
高雄市立普門國民中學國中部	普門中學國中部																	
高雄市立義大國民中學國中部	義大中學國中部																	
高雄市立仁武國民中學國中部	仁武中學國中部	仁武特校國中部																
高雄市立文山國民中學國中部	文山中學國中部																	
高雄市立路竹國民中學國中部	路竹中學國中部																	
高雄市立六龜國民中學國中部	六龜中學國中部																	
高雄市立翠屏國民中小學國中部	翠屏國中小國中部	翠屏附小																
國立高雄師範大學附屬高中國中部	高師大附中國中部																	
高雄市立明義國民中學中安分校	明義國中中安分校																	
高雄餐旅大學附屬餐旅高級中等學校國中部	高餐大附中國中部																	
國立中山大學附屬國光高級中學國中部	中山大學附中國中部	國光中學																
高雄市立成功特殊教育學校國中部	成功啟智學校國中部	成功啟智學校	高雄市立成功啟智學校															
高雄市燕巢區燕巢國小尖山分校	燕巢國小尖山分校																	
高雄中學	高雄第一中學	第一學府雄中	雄中															
高雄女中	雄女																	
高雄高商	雄商																	
高雄高工	雄工																	
高醫	中和紀念醫院	中和醫院																
高楠公路	仁武區高楠公路																	
六合二路夜市	六合夜市																	
瑞北夜市	瑞北路夜市																	
高雄市立深水山公墓	燕巢區深水山公墓	燕巢深水山公墓																
黃埔新村	黃埔眷村																	
二苓市場	小港二苓5號市場																	
鳥松濕地公園	鳥松公園	鳥松濕地																
雙湖森林公園	覆鼎金雙湖公園	覆鼎金雙湖森林公園	雙湖公園															
檨仔林埤濕地公園	三民區檨仔林公園	檨仔林埤	檨仔林埤公園															
小林村紀念公園	甲仙小林村紀念公園	甲仙小林紀念公園																
右昌森林公園	右昌公園	楠梓區右昌森林公園																
高雄都會公園	楠梓都會公園																	
衛武營都會公園	衛武營公園																	
勞動女性紀念公園	25淑女墓																	
凹仔底森林公園	凹仔底公園	凹子底公園	左營凹仔底森林公園	農16森林公園														
中都濕地公園	中都溼地公園	中都濕地																
橋頭糖廠	橋仔頭糖廠																	
翠華陸橋	左營翠華陸橋																	
民族陸橋	三民區民族陸橋																	
苓雅區	芩雅區																	
蚵仔寮漁港	蚵子寮漁港																	
汕尾漁港	汕尾港區																	
興達漁港	興達港漁港																	
中芸漁港	中芸港	林園漁港																
小港區漁會	小港漁會																	
孔廟	孔子廟																	
中國	陸方																	
大林蒲	大林埔																	
大東轉運站	大東轉運中心																	
205兵工廠	二○五兵工廠	二0五兵工廠	二零五兵工廠															
世運主場館	世運																	
世運	世界運動大會	世界運動會	世運會															
荖濃溪	老濃溪																	
旗山溪	楠梓仙溪																	
鳳山溪	鳳山區鳳山溪																	
愛河	仁愛河																	
旗津生命紀念館	生命紀念館	旗津生命館																
中國石油	中油																	
高雄國際機場	小港高雄國際機場	小港國際機場	小港機場															
旗山糖廠	旗山區旗尾糖廠																	
佛光山佛陀紀念館	佛陀紀念館	高雄佛光山	高雄佛陀紀念館															
阿公店水庫	燕巢阿公店水庫																	
阿公店水庫風景區	阿公店水庫																	
大魯閣草衙道	大魯閣草衙道購物中心																	
高雄捷運美麗島站	高捷美麗島站																	
旗後砲台	旗后砲台																	
高雄燈塔	旗后燈塔	旗後燈塔	旗津燈塔															
旗津海水浴場	高雄旗津沙灘																	
壽山動物園	高雄動物園	高雄壽山動物園																
駁二藝術特區	駁二	駁二特區	駁二園區	駁二藝術園區														
曹公圳	鳳山曹公圳																	
高屏大湖	吉洋人工湖																	
茄萣濕地	高雄茄萣濕地																	
衛武營	?武營																	
蓮池潭	蓮潭																	
澄清湖	大貝湖	台灣大貝湖																
德昌營造	德昌																	
鳳儀書院	鳳山鳳儀書院																	
新台17線	新台17縣																	
高雄港	打狗港																	
高雄國際滑輪溜冰場	仁武滑輪溜冰場																	
高雄多功能經貿園區	多功能經貿園區	高雄經貿園區																
高雄巨蛋	巨蛋球場	巨蛋體育場	巨蛋體育館	高雄巨蛋館	高雄巨蛋體育館													
美濃湖	中正湖	中正湖水庫	中圳埤	瀰濃湖														
金獅湖	三民區金獅湖																	
和發產業園區	和發園區																	
亞洲新灣區	亞灣區	南高雄亞洲新灣區																
永安濕地	永安溼地	永安濕地公園																
一卡通	IPass一卡通																	
污水處理廠	水利局污水處理場																	
世界貿易組織	WTO																	
高雄縣	高縣																	
贈與稅	贈予稅																	
公民投票	公投																	
黑面琵鷺	黑琵																	
總統選舉	總統大選																	
選罷法	公職人員選舉罷免法																	
燈會	元宵花燈活動	元宵燈會																
捷運橘線	橘線																	
捷運紅線	紅線																	
國道7號	7號高速公路	7號國道	七號國道	國7	國七													
國家體育場	世大運主場館																	
高雄市建築工程施工損壞鄰房事件爭議調處辦法	建築工程施工損壞鄰房事件爭議調處辦法																	
高速鐵路	高鐵																	
宣誓就職	宣誓																	
空氣污染防制基金	空汙基金	空污基金																
性別平等	性平	兩性平權																
公職人員選舉罷免法	選罷法	公職人員選罷法																
高雄85大樓	85大樓	高雄八五大樓																
88快速道路	88快速道	88高速公路	八八快速道路	台88線														
921大地震	921地震	九二一地震	九二一大地震															
水京棧國際酒店	H2O水京棧	水京棧	H2O水京棧酒店															
愛金卡	icash																	
Wecare高雄	Wecare																	
2009高雄世運	二○○九高雄世運會	2009世界運動會	2009年世運會	2009高雄世界運動會	二○○九世界運動會	二OO九年世運會												
二二八和平紀念公園	二二八紀念公園	228和平公園																
東日本大震災	三一一東日本大震災	日本大地震	311大地震	三一一大地震	日本海嘯													
寶珠溝里活動中心	三民區寶珠溝里活動中心	寶珠溝活動中心																
三民街友服務中心	三民街友中心	三民區遊民收容所	三民遊民收容所															
凡那比風災	凡納比風災	919凡那比颱風																
大林蒲遷村	大林蒲遷村案	大林蒲鳳鼻頭遷村案																
觀音山	大社觀音山	大社區觀音山																
觀音山風景區	大社觀音山風景區																	
公寓大廈管理條例	大廈管理條例																	
旗山太平商場	大溝頂太平商場	大溝頂商場	太平商場	旗山大溝頂商場														
高雄大遠百	大遠百	遠東百貨																
大寮區老人活動中心	大寮長青活動中心	大寮區老人文康中心																
翁園活動中心	大寮翁園活動中心																	
姑山倉庫園區	大樹區姑山倉庫	大樹姑山倉庫	姑山倉庫															
岡山大鵬九村	大鵬九村	大鵬九村眷村																
小林夜祭	小林平埔夜祭活動	小林平埔夜祭																
小林平埔族群文物館	小林平埔族館																	
小港森林公園	小港公園	少康森林園區	少康園區	少康營區公園	小港少康森林公園	小港少康營區	小港少康營區公園	少康森林公園	少康營區									
鹽水港溪	小港區鹽水港溪																	
不動產經紀業管理條例	不動產經紀業條例																	
中正國防幹部預備學校	中正預校																	
中國石油化學公司大社廠	中石化大社廠																	
高雄煉油廠	中油五輕廠	中油後勁煉油廠	中油後勁廠	中油楠梓區後勁廠	中油楠梓廠	中油五輕丁二烯工場	中油五輕後勁廠	中油高雄煉油廠	中油高雄煉油總廠	中油高雄廠	五輕煉油廠	後勁中油廠	後勁五輕	後勁五輕煉油廠	後勁五輕廠	後勁五輕廠區	後勁煉油廠	楠梓煉油廠
中油遷廠	中油五輕遷廠	中油後勁五輕遷廠	中油關廠	中油五輕廠遷廠	中油高雄煉油總廠五輕遷廠	五輕停廠	五輕遷廠	五輕關廠										
高雄煉油廠宿舍	中油宿舍	中油宿舍區																
中油總公司	中油總部																	
高雄市中區污水處理廠	中洲污水處理廠	中洲污水廠																
中鋼	中國鋼鐵	中國鋼鐵公司																
高雄市立圖書館中崙分館	中崙圖書分館	中崙圖晝館	中崙圖書館	鳳山中崙圖書分館														
中都唐榮磚窯廠	中都窯場	中都窯廠	中都磚窯廠	台灣煉瓦會社打狗工場														
中華航空公司	中華航空	華航																
中華郵政	中華郵政公司	郵政																
中興工程顧問股份有限公司	中興工程																	
中鋼公司	中鋼集團																	
內政部營建署城鄉發展分署	內政部營建署城鄉局																	
高雄市區監理所	公路局高雄市區監理所	高雄市監理處	高雄監理站															
交通部公路總局	公路總局																	
台灣公共廣播電視集團	公廣集團																	
六堆客家文化園區	六堆園區																	
十八羅漢山	六龜十八羅漢山																	
彩蝶谷	六龜彩蝶谷																	
高雄市心理復健協會	心理復健協會																	
旗山手巾寮	手巾寮																	
文化部文化資產局	文化部文資局	文化資產局																
文化部文化資源司	文化資源司																	
文化資產保存法	文資保存法	文資法																
日月光事件	日月光汙水案	日月光汙染事件	日月光污染案	日月光案	日月光廢水案	日月光污水案												
原日本海軍鳳山無線電信所	日本海軍無線電信所	日本海軍鳳山無線電信所	日本鳳山電信	鳳山海軍無線電信所	鳳山無線電信所													
日昇蓬萊吊橋	日昇吊橋	蓬萊吊橋																
日間照護中心	日照中心																	
東沙島	月牙島																	
行政院農業委員會水土保持局	水土保持局	水保局	農委會水土保持局	農委會水保局														
台灣自來水公司	水公司	台水	台水公司	自來水公司														
水污染防治法	水污法																	
農田水利會	水利會																	
經濟部水利署	水利署																	
經濟部水利署南區水資源局	水利署南水局	水利署南區水資局	水利署南區水資源局															
行政院農業委員會水產試驗所	水產試驗所	農委會水產試驗所																
世界盃	世界盃足球賽																	
台灣世界展望會	世界展望會	世展會	展望會															
世博	世界博覽會																	
世界運動舞蹈大會	世界運動舞蹈大賽																	
世衛大會	世界衛生大會	WHA																
世衛	世界衛生組織	WHO																
高雄展覽館	世貿展覽館	世貿會展中心	世貿中心展覽館	世貿高雄展覽館	高雄世界貿易展覽會議中心	高雄國際展覽館												
冬奧	冬季奧運																	
高雄市加水站衛生管理自治條例	加水站自治條例	加水站衛生管理自治條例																
半屏山自然公園	半屏山公園	半屏山國家公園																
台1線	台一線	1號省道																
中監	台中監獄																	
台日交流高峰會	台日高峰會																	
北農	台北農產公司	北市農產運銷公司	台北農產運銷公司															
高雄美濃地震	0206大地震	台南大地震	台南永康地震	台南地震														
台北101	101大樓																	
國道10號	10號國道	國10																
嶺口交流道	10號嶺口交流道																	
高雄反空污大遊行	1111高雄反空污大遊行																	
高132線	132線																	
高133線	133線	一三三線																
農16	16特區	農十六特區																
市道186線	186縣道	一八六線																
市道188線	188縣道																	
國道1號	1號高速公路	中山高1號國道	國1	國1中山高	國一													
亞洲運動會	亞運會	亞運																
二二八事件	228事件	228歷史事件																
二二八和平促進會	228和平促進會																	
二二八關懷協會	228關懷協會																	
歐洲聯盟	歐盟																	
福島核災	311核災	三一一福島核災																
太陽花學運	318學運	三一八太陽花運動	三一八太陽花學運	太陽花	太陽花事件	太陽花運動	服貿太陽花學運	學運	學運事件									
319槍擊案	319槍擊事件	三一九槍擊案																
高雄港3號船渠	3號船渠																	
美術館園區重劃區	44期重劃區																	
國軍高雄總醫院	802國軍總醫院	八0二國軍總醫院	高雄國軍總醫院	高雄國軍醫院	國軍高雄醫院	陸軍第八O二總醫院												
岡山87期市地重劃區	87重劃區																	
八八風災	88水災																	
921地震教育園區	921紀念館	九二一地震博物館	台灣九二一地震教育館															
A1交通事故	A1事故																	
A2交通事故	A2事故																	
自動體外心臟去顫器	AED																	
美國在台協會高雄分處	AIT高雄分處																	
荷蘭陽光電城	Amersfoort陽光電城																	
亞太城市高峰會議	APCS亞太城市高峰會議																	
亞太經濟合作會議	APEC亞太經濟合作會議																	
公車捷運系統	BRT																	
高雄市公共腳踏車租賃系統	CBike	C-BIKE																
高雄市數位內容創意中心	DAKUO高雄市數位內容創意中心	高雄數位內容創意中心	數位創意中心															
海峽兩岸經濟合作架構協議	ECFA																	
德國永續綠能示範園區	EUREF-campus永續綠能示範園區																	
F1賽車	F1國際賽事																	
體感園區	FunTech體感園區																	
台灣優良食品發展協會	GMP協會																	
地方政府永續發展理事會	ICLEI																	
國民黨高雄市青工總會	KMT高雄市青工總會																	
億光公司	LED大廠億光																	
台灣國際遊艇展	MIT遊艇展	國際遊艇展	台灣遊艇大展	台灣遊艇展	高雄國際遊艇展													
高雄國際馬拉松	MIZUNO國際馬拉松																	
美國職棒大聯盟	MLB大聯盟																	
國家通訊傳播委員會南區監理處	NCC南區監理處																	
TVBS民調中心	TVBS民意調查中心																	
1114紀念公園	一一一四紀念公園																	
第一商業銀行	一銀																	
731石化氣爆管理委員會	七三一氣爆捐款專戶管理委員會	八一石化氣爆民間捐款專戶管理委員會																
台灣自來水公司第七區管理處	七管處	台灣自來水公司第七管理處	台灣自來水股份有限公司第七區管理處	第七管理處														
熊本地震	九州熊本地震																	
九曲堂轉運站	九曲堂公車站	大樹九曲堂轉運站																
大寮紅豆節	幸福大寮紅豆節	紅豆節																
205兵工廠遷廠	二○五兵工廠遷廠	二0五兵工廠遷廠																
221世界母語日	二二一世界母語日																	
高雄市二二八和平公園	二二八和平紀念公園																	
雄中自衛隊	二二八雄中自衛隊																	
高雄機廠	二聖路台鐵機場	二聖路機廠																
高雄港2號碼頭	二號碼頭																	
人本教育文教基金會	人本基金會																	
人民作主教育基金會	人民作主基金會																	
行政院人事行政總處	人事行政局																	
國際人權公約	人權公約																	
監察院國家人權委員會	人權委員會																	
內政部移民署	入出境管理局	移民署																
氣爆自救會	八一氣爆自救會																	
莫拉克颱風災後重建特別條例	八八特別條例	莫拉克風災條例	莫拉克條例															
85大樓	八五大樓																	
鳥松赤夢山八仙廟	八仙廟																	
八卦寮文教基金會	八卦寮基金會																	
高雄市果菜批發市場	十全果菜市場	十全路果菜市場	三民果菜市場	高雄果菜市	高雄果菜市場	高雄果菜批發市場	覺民路果菜市場											
十全玉市	十全路玉市																	
十鼓橋糖文創園區	十鼓橋頭文創園區																	
廢核遊行	三一四廢核遊行																	
碧雲宮	三奶廟	大社區碧雲宮																
三民二號公園	三民2號公園																	
高雄市立圖書館三民分館	三民市立圖書館	三民圖書館																
三民公共托嬰中心	三民托嬰中心																	
私立亞特蘭幼稚園	三民區亞特蘭幼稚園																	
覆鼎金保安宮	三民區保安宮																	
高醫商圈	三民區高醫商圈																	
褒忠義民廟	三民區義民廟																	
天天新黃昏市場	三民區鼎山街天天心黃昏市場																	
寶業滯洪公園	三民區寶業滯洪公園	寶業里滯洪公園																
鳳山三民路家具街	三民傢俱街																	
小三通首航典禮	三通首航典禮																	
山達基教會	三達基教會																	
六龜三慧寺	三慧寺																	
大社三寶農特產觀光季	三寶農特產觀光季																	
仁武八卦寮上帝宮	上帝宮																	
上海世博會	上海世界博覽會																	
上寮活動中心	上寮多功能活動中心	上寮里民活動中心																
乞龜活動	乞龜大賽	乞龜文化節	乞龜祈福祈平安國際觀光文化節活動															
中國土木水利工程學會	土木水利工程學會																	
高雄市土木技師公會	土木技師工會	高市土木技師公會																
土地法	土地法規																	
土地稅法	土地稅法規																	
地價評議委員會	土地評議委員會																	
地政局土地開發處	土地開發處																	
土壤及地下水污染整治法	土污法																	
大中路	大中高架橋	大中高架橋匝道	大中陸橋															
大坌坑遺址	大坌坑文化新園遺址																	
大坪頂熱帶植物園	大坪頂公園	大坪頂熱帶植物園區																
大坪頂綜合活動中心	大坪頂社區活動中心																	
鳳山水庫	大坪頂鳳山水庫																	
大林蒲自救會	大林蒲生活品質自救會																	
大林蒲污水處理廠	大林蒲污水廠																	
大林蒲活動中心	大林蒲社區康樂活動中心	小港大林蒲活動中心																
大林煉油廠	大林蒲煉油廠	小港煉油廠	中油大林煉油廠	中油公司大林廠	中油高雄大林廠													
大林石化油品儲運中心	大林儲運中心																	
仁大工業區	大社工業區	大社仁大工業區	大社石化工業區	仁大石化工業區	仁武工業區	仁武石化工業區												
觀音牛路巷公園	大社牛路巷公園	中華路牛路巷公園	觀音牛路巷															
大社三奶廟	大社區三奶廟																	
大社中山堂	大社區中山堂																	
大社青雲宮	大社區青雲宮																	
觀音山大覺寺	大社區觀音山大覺寺																	
大社區農會	大社農會																	
高雄市大社回饋基金社會福利協進會	大社福利協進會	高雄縣大社鄉回饋基金社會福利協進會																
大高雄觀光商圈總會	大高雄商圈總會	觀光商圈總會																
嘉新水泥	大崗山嘉新水泥																	
黑心油事件	大統長基混油案	大統毒油事件	大統黑心油事件	黑心油風暴														
大發工業區服務中心	大發工業區管理中心																	
大愛貓頭鷹館	大愛原住民貓頭鷹文化館																	
大愛原民文化公園	大愛園區原住民文化公園																	
鳳山區兒童早期療育發展中心	大鳳山區兒童早期療育服務中心	鳳山早療中心	鳳山區兒童早期療育服務中心															
大發工業區	大寮大發工業區	大寮工業區																
法務部矯正署高雄女子監獄	大寮女子監獄																	
大寮機廠	大寮主機廠	大寮捷運主機廠																
高雄市立圖書館大寮分館	大寮第一圖書館	大寮圖書館																
大寮區農會	大寮農會																	
法務部矯正署高雄監獄	大寮監獄																	
高雄捷運南機廠	大魯閣捷運機廠	捷運南機廠																
坪頂給水廠	大樹坪頂給水廠																	
大樹區果菜市場	大樹果菜市場																	
高雄市立圖書館大樹分館	大樹圖書館																	
大樹舊鐵橋	大樹舊鐵橋公園	大樹舊鐵橋遊客中心	大樹舊鐵橋濕地公園															
蔡英文高雄市競選總部	小英高市競選總部																	
大林發電廠	小港大林發電廠	中油大林發電廠																
臨海工業區	小港工業區	小港臨海工業區																
小港特倉區	小港中安路特倉區																	
小港航空貨運園區	小港航空貨櫃園區																	
大鳳居民權益關懷協會	小港區大鳳居民權益關懷協會																	
捷運小港站	小港捷運站																	
高雄市立圖書館小港分館	小港圖書館																	
高雄國際航空站	小港機場航站	高雄國際機場																
高雄國際機場站	小港機場捷運站	高雄機場站																
小港轉運站	小港轉運中心																	
小港中正體育場	小港體育場																	
山坡地保育利用條例	山坡地保育法	山坡地保育條例																
金屬工業研究發展中心	工研院金屬研究中心	金屬工業中心	金屬中心	金屬研究中心	金屬研發中心													
工商建設研究會南區聯誼會	工商建研會南區聯誼會																	
不老溫泉	不老溫泉區																	
前鎮之星	中山自行車橋	中山凱旋自行車橋																
鼎金系統交流道	中山高鼎金系統交流道																	
少子化專案辦公室	中央少子化專案辦公室																	
航港建設基金	中央航港建設基金																	
行政院莫拉克重建委員會	中央莫拉克重建委員會																	
中選會	中央選舉委員會																	
中正運動場	中正體育場																	
中國石油化學工業開發	中石化																	
高雄市立圖書館中庄分館	中庄圖書館																	
永安液化天然氣廠	中油永安廠	天然氣事業部永安廠																
中油油品行銷事業部高雄營業處	中油油品行銷事業部高雄營業處供油中心																	
中油污染案	中油的污染案件																	
中油前鎮儲運所	中油前鎮儲運站																	
高雄後勁中油遷廠促進會	中油高雄廠遷廠促進會	中油遷廠促進會																
中油綠能科技研究所	中油綠能科技																	
台灣石油工會	中油總工會																	
高雄市政府水利局中區污水處理廠	中洲汙水處理廠																	
國家中山科學研究院	中科院																	
青年和平團	中國青年和平團																	
救國團	中國青年救國團																	
海協會	中國海協會	中國海峽兩岸關係協會																
國台辦	中國國台辦																	
國民黨中常會	中國國民黨中常會																	
國民黨文傳會	中國國民黨文傳會																	
民眾服務社	中國國民黨民眾服務社																	
國民黨立法院黨團	中國國民黨立法院黨團																	
國民黨政策委員會	中國國民黨政策委員會																	
國民黨高雄市委員會	中國國民黨高雄市委員會																	
國民黨高雄市黨部	中國國民黨高雄市黨部																	
中崙濕地公園	中崙溼地公園																	
中崙污水處理廠	中崙廢水處理廠																	
中科	中部科學園區																	
中博高架橋	中博陸橋																	
拉瓦克部落	中華五路拉瓦克	中華五路建隆部落																
中華奧會	中華台北奧會																	
大地工程技師公會	中華民國大地工程技師公會																	
工商建研會	中華民國工商建研會																	
國際青年商會中華民國總會	中華民國青商會	青商會總會	國際青商總會															
消基會	中華民國消費者文教基金會																	
中華民國超馬協會	中華民國超級馬拉松跑者協會																	
中華民國滑水總會	中華民國滑水協會																	
全國農會	中華民國農會																	
中華民國運輸學會	中華民國運輸協會																	
外貿協會	中華民國對外貿協會	中華民國對外貿易發展協會																
中華民國足球協會	中華足球協會																	
中華卓越國際公益協會	中華卓越公益協會																	
中華卓越青工總會	中華青工總會																	
華航	中華航空公司																	
中華民國婦女聯合會	中華婦女聯合會	婦聯會																
中華民國野鳥學會	中華鳥會																	
中華民國棒球協會	中華棒協																	
中華奧林匹克委員會	中華奧會																	
高雄市公車中華幹線	中華幹線公車																	
中華道教總會	中華道教																	
中華電信	中華電信公司																	
中華職棒	中華職棒大聯盟																	
中嘉網路	中嘉	中嘉公司																
中橫	中橫公路																	
中聯資源股份有限公司	中聯資源公司																	
中鋼爐渣案	中聯爐石																	
中纖公司高雄總廠	中纖	中纖公司																
515國際家庭日	五一五國際家庭日																	
五六七大聯盟	五六七聯盟																	
五甲公園	五甲社區公園																	
五甲國宅社區管理委員會	五甲社區管理委員會																	
五甲社會福利服務館	五甲社福中心																	
五甲國宅	五甲國民住宅社區																	
五甲龍成宮	五甲媽祖廟	鳳山龍成宮	龍成宮															
鳳農市場	五甲鳳農市場	鳳山鳳農市場																
五甲協善心德堂	五甲關帝廟	鳳山五甲協善心德堂	鳳山五甲關帝廟															
五甲超高壓變電所	五甲變電所																	
五常里集會所	五常里活動中心																	
龍濟宮	五福里龍濟宮																	
五福商圈	五福新堀江商圈																	
中油五輕	五輕																	
仁大工業區服務中心	仁大加工區																	
中山大學仁武校區	仁武中山大學分校	仁武中山大學校區																
社團法人高雄市仁武老人福利協進會	仁武老人福利協進會																	
仁武區里長聯誼會	仁武里長聯誼會																	
仁武產業園區	仁武科技園區																	
八卦休閒公園	仁武區八卦休閒公園																	
草潭埤	仁武區八卦寮草潭埤	仁武區草潭埤																
高雄仁武區永宏工業園區	仁武區永宏工業園區管理委會																	
獅龍溪	仁武區獅龍溪	仁武獅龍溪																
仁武運動公園	仁武區運動公園																	
仁武殯儀館	仁武區殯儀館																	
仁武焚化廠	仁武焚化爐																	
觀音湖	仁武觀音湖																	
九曲堂仁美軍營	仁美兵營																	
元旦升旗	元旦升旗典禮	元旦升旗活動																
高雄市立圖書館內門木柵分館	內門七星塔																	
光興社區發展協會	內門區光興社區																	
溝坪社區發展協會	內門區溝坪社區發展協會																	
內門墩仔腳橋	內門區墩仔腳橋																	
內門動物園	內門野生動物園																	
內門區農會	內門農會																	
內門紫雲宮	內門觀亭里紫雲宮	觀亭里紫雲宮																
內惟車站	內惟火車站																	
內惟埤文化園區	內惟埤溼地																	
林園海洋溼地公園	公12海洋濕地公園	海洋濕地公園																
鳳山公28公園	公28公園																	
公民權利和政治權利國際公約	公民政治權利國際公約	公民與政治權利國際公約																
監票者聯盟	公民監票聯盟																	
行政院公共工程委員會	公共工程委員會	公共工程會	共公工程															
行政院公共工程委員會組織條例	公共工程條例																	
公民投票法	公投法																	
公投護台灣聯盟	公投盟																	
台灣公務革新力量聯盟	公革力聯盟																	
公職人員利益衝突迴避法	公務人員利益迴避法																	
公務員服務法	公務人員服務法																	
高雄市公務機關總工會	公務機關總工會																	
公共債務法	公債法																	
611水災	六一一水災																	
六塊厝車站	六塊厝站																	
六龜日照中心	六龜區日間照顧中心																	
六龜區農會	六龜農會																	
台灣各地議會友日議員聯盟	友日議員聯盟																	
反五輕	反五輕紀念活動	反五輕運動																
南部反空汙大聯盟	反空汙大聯盟																	
反國道七號自救會	反國七自救會																	
反對逃犯條例修訂草案運動	反對逃犯條例																	
高雄市天彰慈善協會	天彰慈善協會																	
臺灣高雄少年及家事法院	少年法庭																	
少輔會	少年輔導委員會																	
少年輔導委員會	少輔會																	
巴黎協議	巴黎協定	巴黎協約																
高雄市文化中心分館	文化中心圖書館																	
文化局文創發展中心	文創發展中心																	
赤山文衡殿	文衡殿	鳳邑赤山文衡殿																
日本台灣交流協會高雄事務所	日本交流協會高雄事務所																	
日間照顧中心	日托中心																	
日軍震洋隊神社遺址	日軍神社遺址																	
月眉橋	月眉大橋																	
水門案	水門事件																	
水土保持法	水保法																	
台灣區水管工程工業同業公會	水管會																	
中都開王殿保留案	開王殿保留案																	
地球日活動	世界地球日環保活動																	
高雄國家體育場	世運主場館	世運國家體育場																
世界衛生組織	世衛組織																	
世界錦標賽	世錦賽																	
財團法人世豐善智慈善事業基金會	世豐善智基金會																	
主婦聯盟環境保護基金會	主婦聯盟保護基金會																	
農16重劃區	凹仔底重劃區																	
經濟部加工出口區管理處	加工出口區管理																	
台灣北社	北社																	
北高雄家扶中心	北高家扶中心																	
高雄市立兒童美術館	北高雄兒童美術館	兒童美術館																
北長青綜合服務中心	北高雄長青綜合活動中心																	
高雄市北高雄溜冰協會	北高雄溜冰協會																	
台北捷運公司	北捷公司																	
北漂青年	北漂青團																	
本洲工業區	北嶺里本洲工業區																	
半屏山儲運站	半屏山油品儲運站																	
高雄市政府處理被占用市有不動產作業要點	占用市有不動產作業要點																	
市道181號	台181線																	
台25線鳳林公路	台25線鳳林																	
台一線湖內段拓寬案	台一線拓寬案																	
台27線	台二十七線																	
台29線	台二十九線																	
台22線	台二十二線																	
台28線	台二十八線																	
台20線	台二十線																	
台20線南橫公路	台二十線南橫公路																	
台20線勤和	台二十線勤和																	
台20線寶來	台二十線寶來																	
台17線	台十七線																	
台19甲線	台十九甲線																	
台3線	台三線																	
台中快捷巴士	台中BRT																	
日本台灣交流協會	台日交流協會																	
臺灣日本關係協會	台日關係協會																	
台灣石化合成集團	台石化																	
臺灣中小企業銀行	台企銀																	
臺灣汽車客運公司	台汽																	
台協化學股份有限公司	台協公司	台協化學																
台灣水泥	台泥	台泥公司																
台灣水泥高雄廠	台泥高雄鼓山廠	台泥高雄廠	台泥鼓山廠	台泥鼓山廠區	淺野水泥工場													
台灣肥料股份有限公司	台肥	台肥公司																
奇美博物館	台南市奇美博物館	台南奇美博物館																
台南維冠金龍大樓	台南永康維冠大樓	台南維冠大樓																
台南社區大學環境行動小組	台南社大環境行動小組																	
台玻集團	台玻																	
台灣苯乙烯工業股份有限公司	台苯																	
台虹科技股份有限公司	台虹																	
台灣大哥大	台哥大																	
國立臺灣師範大學	台師大																	
台灣旅行法	台旅法																	
台灣海峽兩岸觀光旅遊協會	台旅會																	
台郡科技股份有限公司	台郡公司	台郡科技	台郡科技公司															
台灣啤酒	台啤																	
台灣彩券	台彩	台灣彩券公司																
台灣垃圾掩埋場	台掩埋場																	
台灣國際造船股份有限公司	台船	台船公司	台灣國際造船	台灣國際造船公司														
台灣氯乙烯工業股份有限公司	台氯	台氯公司	台灣氯乙烯公司															
台灣發展研究院	台發院																	
臺灣電視公司	台視																	
臺灣航勤股份有限公司	台勤	台勤公司																
臺灣塑膠工業股份有限公司	台塑																	
台塑仁武廠	台塑公司仁武廠																	
台塑石化股份有限公司	台塑石化	台塑石化公司																
南亞塑膠工業股份有限公司	台塑南亞																	
台灣經濟研究院	台經院																	
台農發股份有限公司	台農發公司																	
台達化學工業股份有限公司	台達化	台達化學																
台灣電力股份有限公司	台電	台電公司																
台電大林發電廠	台電大林電廠	台電大林廠	台電小港區大林電廠	台電公司大林廠														
台電南部火力發電廠	台電南部發電廠																	
台灣電力公司高雄區營業處	台電高雄區營運處																	
台灣電力公司鳳山區營業處	台電鳳山區營業處	台電鳳山營業處																
台電興達火力發電廠	台電興達發電廠	台電興達電廠	台電興達廠															
台灣綜合研究院	台綜院																	
台維斯盃網賽	台維斯																	
台灣聚合化學品股份有限公司	台聚	台聚公司																
台灣銀行	台銀																	
台鳳股份有限公司	台鳳公司																	
MLD台鋁生活商場	台鋁MLD	台鋁商圈																
台橡股份有限公司	台橡																	
台灣獨立	台獨																	
台灣積體電路製造股份有限公司	台積電																	
台灣糖業股份有限公司	台糖	台糖公司	台灣糖業公司															
台糖高雄物流園區	台糖成功物流園區																	
台糖高雄花卉農園中心	台糖花卉農園中心																	
台聯高雄市黨部	台聯高市黨部	台聯高雄黨部																
台駿國際租賃	台駿																	
台燿科份有限公司	台燿																	
國立臺灣藝術大學	台藝大	國立台灣藝術大學																
台耀化學股份有限公司	台耀	台耀公司																
台耀石化材料科技公司	台耀石化	台耀石化材料公司																
臺灣鐵路管理局	台鐵	台鐵局	台鐵管理局	台灣鐵路局	台灣鐵路管理局	鐵路局	鐵路管理局											
台灣鐵路工會	台鐵工會																	
台鐵新左營站	台鐵左營新站	左營台鐵新站																
台鐵前鎮調車場	台鐵前鎮調度場																	
台鐵高雄站	台鐵高雄火車站																	
台鐵高雄港車站	台鐵高雄港站																	
哈瑪星鐵道文化園區	台鐵高雄港站鐵道文化園區	哈瑪星鐵路文化園區	哈瑪星鐵道園區	高雄港鐵道園區	駁二鐵道園區	鐵道文化園區	鐵道園區											
台鐵普悠瑪列車	台鐵普悠瑪	台鐵普悠瑪號																
國立臺灣體育運動大學	台體	台體大																
台灣實業股份有限公司	台鹽																	
台灣人壽保險	台灣人壽																	
台灣三星電子	台灣三星																	
台灣大哥大股份有限公司	台灣大哥大																	
國立臺灣大學	台灣大學																	
台灣中油股份有限公司	台灣中油	台灣中油公司	台灣石油															
台灣互動電視股份有限公司	台灣互動電視公司																	
臺灣文博會	台灣文博會																	
國立臺灣文學館	台灣文學館																	
台灣木蘭足球聯賽	台灣木蘭女子足球聯賽																	
台灣世曦工程顧問股份有限公司	台灣世曦工程																	
馬英九競選辦公室	台灣加油讚																	
台灣失智症協會	台灣失智協會																	
臺灣民主人權平台	台灣民主人權平台																	
臺灣民主國	台灣民主國																	
台灣民意教育基金會	台灣民意基金會																	
台灣石化合成股份有限公司	台灣石化																	
台灣區石油化學同業公會	台灣石化公會																	
臺灣行動支付股份有限公司	台灣行動支付公司																	
台灣汽電共生股份有限公司	台灣汽電																	
台灣和平中立大同盟	台灣和平大同盟																	
臺灣金融控股	台灣金控																	
臺灣保母總會	台灣保母總會																	
台灣信徹蓮池功德會	台灣信徹寺蓮池公德會																	
前國軍台灣退役軍人暨遺族協會	台灣前國軍退役軍人暨遺族協會																	
亞洲台灣客家聯合總會	台灣客家聯合總會																	
臺灣盃全國書法比賽	台灣盃全國書法比賽																	
台灣盃全國美容美髮家事技術競賽	台灣盃美容美髮家事技術競賽																	
台灣省結構工程技師公會	台灣省結構技師公會																	
中華民國全國運動會	台灣省運動會	全國運動會	全運會															
中華民國全國漁會	台灣省漁會																	
台灣總工會	台灣省總工會																	
臺灣省議會	台灣省議會																	
臺灣軍	台灣軍																	
台灣恩智浦半導體股份有限公司	台灣恩智浦公司																	
台灣海洋科技研究中心	台灣海洋研究中心	海洋科技中心	海洋科技研究中心															
中華民國海軍	台灣海軍																	
台灣消費者保護協會	台灣消保會																	
高雄市	台灣高雄	台灣高雄市	港都	港都高雄														
台灣高雄市長盃美容美髮美甲美睫技術競賽大會	台灣高雄市長盃全國美容美髮造型技術競賽大會																	
台灣高鐵	台灣高鐵公司	高鐵																
台灣水產工業同業公會	台灣區冷凍水產工業同業公會																	
台灣區造船工業同業公會	台灣區造船公會	造船公會																
臺灣遊艇工業同業公會	台灣區遊艇工業同業公會	台灣區遊艇公會	台灣遊艇工業同業公會	台灣遊艇公會	臺灣遊艇公會													
國光石化開發案	台灣國光石化																	
臺灣國際農業開發公司	台灣國際農業開發公司																	
臺灣國際漁業展	台灣國際漁業展																	
台灣基進黨	台灣基進	台灣激進黨																
全國產業總工會	台灣產業總工會																	
高雄國際海事船舶暨國防工業展	台灣第一屆國際海事展	國際海事船舶暨國防工業展																
台灣造船工業同業公會	台灣造船公會																	
臺灣港務公司	台灣港務公司																	
臺灣港務股份有限公司高雄港務分公司	台灣港務公司高雄分公司	港務公司高雄分公司																
臺灣港務國際物流股份有限公司	台灣港務物流公司																	
台灣塑膠工業股份有限公司	台灣塑膠工業公司	台灣塑膠公司																
台灣微軟	台灣微軟公司																	
國際獅子會台灣總會	台灣獅子會																	
臺灣道教研究會	台灣道教研究會																	
臺灣電視台	台灣電視頻道																	
臺灣綜合研究院	台灣綜合研究院																	
台灣聚合化學品公司股份有限公司	台灣聚合化學品公司																	
臺灣銀行	台灣銀行																	
台灣檢驗科技股份有限公司	台灣檢驗科技公司																	
台灣濕地保護聯盟	台灣濕盟																	
臺灣營建研究院	台灣營建研究院																	
台灣環境保護聯盟	台灣環保聯盟	環保聯盟																
台灣螺絲工業同業公會	台灣螺絲公會																	
臺灣藝術研究院	台灣藝術研究院																	
臺灣證券交易所	台灣證交所	台灣證券交易所																
右昌元帥廟	右昌元帥府	右昌元帥府廟																
右昌民營市場	右昌市場																	
楠梓分局右昌派出所	右昌派出所																	
右昌高鐵線	右昌捷運線																	
楠梓區右昌游泳池	右昌游泳池																	
民間司法改革基金會	司改會	民間司改會																
公務員懲戒委員會	司法院公務員懲戒委員會																	
汶川大地震	四川地震																	
四川民族歌舞交流團	四川歌舞交流團																	
四維行政中心	四維中心	四維市政大樓	四維行政大樓															
中正技擊館	四維技擊館	技擊館																
高雄市政府社會局長青綜合服務中心	四維路長青老人服務中心																	
林園石化廠	四輕																	
中華民國對外貿易發展協會	外貿協會																	
國家運動訓練中心	左訓中心	國家運動中心	國訓中心															
高雄立市圖書館左新分館	左新分館	左新圖書館																
左營三鐵共構	左營三鐵共站	左營三鐵站																
高雄左營孔子廟	左營孔廟	左營區孔廟																
高雄世運主場館	左營世運主場館																	
台鐵左營站	左營台鐵																	
果貿社區	左營果貿	左營區果貿社區																
衛生福利部南區兒童之家	左營南區兒童中心	衛福部南區兒童之家																
高雄市體育處左營活動中心	左營活動中心																	
左營港	左營軍港																	
國軍高雄總醫院左營分院	左營海軍醫院	國軍左營醫院																
高鐵左營站	左營高鐵車站	左營高鐵站																
高雄榮民總醫院	左營區高雄榮總	高雄榮總	高榮	榮民總醫院														
高雄捷運左營站	左營捷運站	高捷左營站																
臺灣眷村文化園區	左營眷村文化園區																	
高雄市眷村文化館	左營眷村文化館	眷村文化館																
原生植物園	左營植物園																	
高雄左營萬年季	左營萬年祭																	
高雄市立圖書館左營分館	左營圖書分館	左營圖書館																
左營實踐公共托嬰中心	左營實踐公託中心																	
漢神巨蛋購物廣場	左營漢神巨蛋	巨蛋商場	巨蛋漢神百貨															
高雄市舊城文化協會	左營舊城文化協會	舊城文化協會																
高雄捷運巨蛋站	巨蛋捷運站																	
高雄市立大同醫院	市立大同醫院																	
高雄市立國際游泳池	市立國際游泳池																	
高雄市立鳳山醫院	市立鳳山醫院	鳳山醫院																
高雄市立殯儀館	市立殯儀館																	
高雄市役所	市役所																	
高雄市政府公害糾紛調處委員會	市府公害糾紛調處委員會																	
高雄市政府台北聯絡處	市府台北聯絡處																	
高雄市政府四維行政中心	市府四維行政大樓	市府四維行政中心																
高雄市政府交通局交通事件裁決中心	市府交通裁決中心	交通事件裁決中心																
高雄市性別平等教育委員會	市府性平教育委員會	高雄市教育局性平委員會																
高雄市政府所轄機關工會總工會	市府所轄機關工會總工會																	
高雄市政府工務局建築管理處	市府建管處																	
高雄市市長盃扯鈴暨民俗體育錦標賽	市長盃扯鈴暨民俗體育錦標賽																	
高雄市災害應變中心	市政府災害防治應變中心																	
高雄市產業總工會	市產總	高市產業總工會	高雄市產業公會	高雄產業總工會														
高雄市選舉委員會	市選委會	高雄市選委會																
高雄市濟興護老慈善會	市濟興護老慈善會																	
高雄市議會無黨聯盟	市議會無黨聯盟																	
林園力行新村平水廟	平水廟																	
高雄市實施平均地權基金收支管理及運用自治條例	平均地權自治條例																	
高雄本洲產業園區	本洲工業區	本洲工業園區																
岡山垃圾焚化廠	本洲焚化爐	岡山本洲焚化爐																
正隆股份有限公司	正隆公司																	
正義股份有限公司	正義公司	正義油品公司																
台鐵正義車站	正義澄清站																	
高雄市民俗體育運動委員會	民俗體育運動委員會																	
交通部民用航空局	民航局																	
交通部民用航空局高雄國際航空站	民航局高雄機場																	
民間全民電視公司	民視																	
高雄民權公園	民權公園																	
永安液化天然氣接收站	永安天然氣接收站	永安液化天然氣廠																
永安區永新漁港	永安永新漁港																	
永安石斑魚節	永安石斑魚文化節																	
高雄市永安區永安宮	永安宮																	
誠毅紙器股份有限公司永安廠	永安紙廠	永安紙器廠																
高雄市立圖書館永安分館	永安圖書館																	
永安區漁會	永安漁會																	
永新漁港安檢所	永新安檢所																	
仁武永達工業區	永達工業區																	
永豐商業銀行	永豐銀行																	
永豐餘工業用紙股份有限公司	永豐餘																	
永豐餘工業用紙股份有限公司高雄廠	永豐餘紙廠																	
永齡農場	永齡有機農場	永齡杉林有機農業區	永齡農業園區	杉林永齡有機農場	杉林永齡農場	杉林區永齡有機農場												
玉山	玉山山脈																	
玉山銀行	玉山銀																	
高雄市玉皇宮	玉皇宮																	
生祥樂隊	生祥樂團																	
生煤管制自治條例	生煤管制條例																	
田寮月世界	田寮奇幻月世界																	
高雄市田寮區衛生所	田寮衛生所																	
2010年高雄地震	甲仙大地震	甲仙地震																
甲仙區形象商圈促進會	甲仙形象商圈促進會																	
甲仙區農會	甲仙農會																	
高雄市立圖書館甲仙分館	甲仙圖書館																	
美濃白玉蘿蔔季	白玉蘿蔔季																	
白屋藝文中心	白屋藝術中心																	
張安樂	白狼																	
高雄茄萣區白雲寺	白雲寺																	
高雄市政府七三一石化氣爆事件民間捐款專戶管理會	石化氣爆事件民間捐款專戶管理會																	
高雄市石化業總工會	石化聯合總工會																	
楠梓立民公園	立民公園																	
林佳龍	交長林佳龍																	
交通部臺灣鐵路管理局	交通部台鐵管理局																	
茂林國家風景區管理處	交通部觀光局茂林國家風景區管理處	交通部觀光局茂管處	茂管處															
伊甸社會福利基金	伊甸基金會																	
伊東豊雄	伊東豐雄																	
伊斯坦大·貝雅夫·正福	伊斯坦大	伊斯坦大?貝雅夫?正福	伊斯坦大.貝雅夫	伊斯坦大.貝雅夫.正福	伊斯坦大?貝雅夫	伊斯坦大?貝雅夫?正福	伊斯坦大-貝雅夫	伊斯坦大‧貝雅夫	伊斯坦大‧貝雅夫‧正福	伊斯坦大議員								
兆豐國際商業銀行	兆豐銀行																	
兆豐證券股份有限公司	兆豐證券																	
高雄市光華慢跑協會	光華慢跑協會																	
光陽工業股份有限公司	光陽工業	光陽公司																
全國中等學校運動會	全中運																	
全國大專校院運動會	全國大專運動會																	
中華民國全國公務人員協會	全國公務人員協會																	
全國少棒錦標賽	全國少棒賽																	
全國羽球團體錦標賽	全國羽球錦標賽																	
國際青年商會	全國青商會																	
國中教育會考全國試務會	全國試務會																	
全國議會議長盃桌球錦標賽	全國議長盃桌球錦標賽	全國議會盃桌球錦標比賽	全國議會桌球賽															
高雄市共享運具發展管理自治條例	共享運具相關管理自治條例																	
都市危險及老舊建築物加速重建條例	危老重建條例																	
合作金庫商業銀行	合作金庫銀行																	
合作金庫金融控股	合庫金控																	
合發土地開發股份有限公司	合發土地開發(股)有限公司	合發土地開發公司	合發公司															
台灣同志家庭權益促進會	同志權益促進會																	
高雄市向陽自立生活協會	向陽自立生活協會																	
地方民意代表費用支給及村里長事務補助費補助條例	地方民代支給條例	地方民意代表費用支給條例																
地方稅法通則	地方稅法																	
地勇選礦股份有限公司	地勇選礦公司																	
高雄市關懷地球協會	地球關懷協會																	
經濟部中央地質調查所	地質研究所																	
鼓山地嶽殿	地嶽殿																	
臺灣高雄地方地檢署	地檢署																	
安泰商業銀行	安泰銀																	
國家年金改革委員會	年金改革委員會																	
國立成功大學醫學院附設醫院	成醫																	
鴨母寮朱一貴文化園區	朱一貴文化園區																	
朱一貴事件	朱一貴民變事件																	
朱宗慶打擊樂團	朱宗慶樂團																	
高雄市茄萣舢筏協會	汕筏協會																	
高雄市污水下水道使用管理自治條例	污水下水道自治條例																	
竹仔門發電廠	竹子門發電廠	竹子門電廠	竹仔門電廠	竹門發電廠														
橋頭竹林公園	竹林公園																	
竹梅源育樂事業股份有限公司	竹梅源公司	竹梅源育樂公司	竹梅源育樂事業公司															
台灣羊毛氈推廣協會	羊毛氈推廣協會																	
中華民國老人福利推動聯盟	老人福利推動聯盟																	
老年農民福利津貼暫行條例	老農福利津貼暫行條例																	
自由民主黨	自民黨																	
自由時代周刊	自由時代週刊																	
鳳山自強陸橋	自強陸橋																	
高雄市自閉症協進會	自閉症協會																	
自由貿易港區設置管理條例	自貿區條例																	
自由經濟示範區特別條例草案	自經區條例																	
高雄市文化中心至德堂	至德堂	高雄至德堂																
台灣血液基金會	血液基金會																	
公務人員行政中立法	行政中立法																	
行政院性別平等委員會	行政院性平委員會																	
行政院南部聯合服務中心合署辦公大樓	行政院南部中心大樓																	
行政院莫拉克颱風災後重建推動委員會	行政院重建委員會	行政院重建會																
行政院消費者保護委員會	行政院消保會																	
行政區劃法草案	行政區劃分法	行政區劃法																
一邊一國行動黨	行動黨																	
高雄市行道樹管理維護辦法	行道樹栽植管理自治條例																	
高雄行德宮	行德宮																	
打狗英國領事館	西子灣英國領事館																	
西子灣風景區	西子灣風景特定區																	
高雄捷運西子灣站	西子灣站	西子灣捷運站	高捷橘線西子灣站															
西濱快速公路	西濱公路																	
西濱快速道路南區工程處	西濱南區工程處																	
西臨港線自行車道	西臨港線																	
余陳月瑛	余陳月英																	
余登發故居	余登發紀念館																	
草衙佛公天后宮	佛公天后宮																	
君鴻國際酒店	君鴻酒店	君鴻飯店	高雄金典酒店	高雄金典飯店														
宏碁集團	宏碁																	
劉大潭希望工程關懷協會	希望工程關懷協會																	
高雄市志明之友關懷協會	志明之友關懷協會																	
快樂聯播網	快樂電台	快樂聯播網空中電台	快樂聯播網電台															
高雄捷運技擊館站	技擊館站																	
杉林區大愛園區	杉林大愛園區																	
杉林區大愛園區原住民文化公園	杉林大愛園區原住民文化公園																	
杉林區農會	杉林農會																	
高雄市立圖書館杉林分館	杉林圖書館																	
李長榮化學工業股份有限公司	李長榮化工公司	李長榮化學	李長榮化學工業公司	李長榮石化														
李長榮化工大社廠	李長榮化學工業大社廠	李長榮高雄大社廠																
高雄市立圖書館李科永紀念圖書館	李科永紀念圖書館	李科永圖書館	高雄市李科永紀念圖書館	高雄李科永圖書館														
李科永文教基金會	李科永基金會																	
杜邦公司	杜邦																	
國家災害防救科技中心	災防中心																	
中央災害應變中心	災害應變中心																	
甲仙芋筍節	芋筍節																	
谷辣斯‧尤達卡	谷辣斯	谷辣斯.尤達卡																
高雄市身心障礙團體聯合總會	身心障礙者總會	身心障礙總會	身障總會															
高雄市身心障礙桌球協會	身心障礙桌球協會																	
中華民國身心障礙聯盟	身心障礙聯盟																	
身心障礙者權益保障法	身心障礙權益保障法																	
中華身障體育運動協會	身障運動協會																	
車諾比事件	車諾比核災	車諾比核電廠事故																
高雄市立圖書館那瑪夏分館	那瑪夏分館																	
阪神大地震	阪神地震																	
行政院農業委員會動植物防疫檢疫局	防檢局																	
亞洲蔬菜研究發展中心	亞洲蔬菜研究中心																	
高雄大寮區兒3-2兒童遊戲場	兒3-2兒童遊戲場																	
兒童及少年福利法	兒少法																	
高雄市兒童少年驗傷醫療整合中心	兒童少年驗傷醫療整合中心																	
高雄市政府社會局兒童福利服務中心	兒福中心																	
臺灣地區與大陸地區人民關係條例	兩岸人民關係條例																	
兩岸協議監督條例草案	兩岸監督條例																	
周大觀文教基金會	周大觀基金會																	
味全食品工業股份有限公司	味全公司																	
味全龍隊	味全龍																	
呷百二自然洋果子有限公司	呷百二																	
和歌山市議會	和歌山議會																	
台灣自來水公司坪頂給水廠	坪頂自來水廠	坪頂淨水場	坪頂淨水廠															
大坪頂熱帶植物園區	坪頂熱帶植物園																	
岡山鎮大專青年協會	岡山大專青年協會																	
岡山大空襲	岡山大轟炸																	
岡山本洲工業區	岡山工業區																	
台灣牛肉麵故事館	岡山牛肉麵博物館																	
岡山本洲產業園區	岡山本洲工業區	岡山本洲工業園區	岡山本洲產業區															
岡山地區農會	岡山地區區農會																	
岡山羊肉文化節	岡山羊肉節																	
秀傳醫院	岡山秀傳醫院																	
高雄市岡山里長服務促進會	岡山里長服務促進會																	
岡山焚化廠	岡山垃圾廠	岡山焚化爐																
空軍航空教育展示館	岡山官校航空教育展示館	岡山航空教育展示館																
岡山果菜批發市場	岡山果菜公司	岡山果菜市場																
高雄市岡山社區大學	岡山社區大學																	
中華民國空軍軍官學校	岡山空軍官校																	
岡山車站	岡山區火車站																	
中華民國空軍官校	岡山區空軍官校																	
高雄捷運南岡山站	岡山區捷運站	高捷南岡山站																
岡山壽天宮	岡山區壽天宮	壽天宮																
岡山魚市場	岡山魚市																	
高雄岡山棒球場	岡山棒球場																	
岡山橋頭污水處理廠	岡山橋頭污水廠																	
高雄市立岡山醫院	岡山醫院																	
帕莎蒂娜烘培坊	帕莎蒂娜																	
高雄市忠孝路忠孝公園	忠孝公園																	
高雄忠烈祠	忠烈祠																	
高雄市社會忠義推廣協會	忠義推廣協會																	
旺旺中時媒體集團	旺中集團	旺旺中時	旺旺集團															
高雄市前鎮區明正公園	明正公園																	
高雄市前鎮區明鳳橋	明鳳橋																	
明德建業新村社區發展協會	明德建業眷村文化發展協會																	
明德新村	明德眷村																	
海崍兩岸服務貿易協議	服貿																	
海峽兩岸服務貿易協議	服貿協議																	
東亞青年運動會	東亞青運																	
東亞奧林匹克委員會協會	東亞奧會																	
東亞運動會	東亞運																	
東京國際食品展	東京食品展	國際東京食品展																
東南亞國家協會	東協																	
東南水泥股份有限公司	東南水泥	東南水泥公司																
東南汽車客運股份有限公司	東南客運公司																	
東森新聞台	東森新聞																	
東森電視	東森電視台																	
大鵬灣國家風景區	東港大鵬灣	東港大鵬灣風景區																
台鐵東臨港線	東臨港線																	
林口長庚醫院	林口長庚																	
高雄林皇宮	林皇宮																	
林郁方	林郁芳																	
林宅血案	林家血案																	
行政院農業委員會林務局	林務局	國有林務局	農委會林務局															
林務局屏東林區管理處	林務局屏管處																	
高雄市立圖書館林園二館	林園二館																	
林園區中芸漁港	林園中芸港	林園中芸漁港																
林園紅樹林保育學會	林園紅樹林學會																	
林園夢工廠	林園夢工場																	
欣高石油氣股份有限公司	欣高	欣高天然氣公司	欣高瓦斯															
欣雄天然氣公司	欣雄	欣雄公司	欣雄瓦斯															
高雄武德殿	武德殿																	
高雄市立圖書館河堤分館	河堤圖書館																	
河邊海鮮餐廳	河邊餐廳																	
法律扶助基金會	法律服務基金會																	
波特蘭	波特蘭市																	
高雄物產館蓮潭旗艦店	物產館旗艦店	高雄物產館蓮潭旗鑑店																
高雄市盲人福利協進會	盲人福利協進會																	
社會秩序維護法	社維法																	
空氣污染防制法	空汙法	空污法	空氣汙染防制法															
邵曉鈴	邵曉玲																	
大高雄金鑽觀光夜市	金鑽夜市																	
台灣長期照護學會	長期照護協會																	
大崗山自然生態園區	阿蓮生態公園																	
促進民間參與公共建設法	促參法																	
高雄市促進產業發展自治條例	促進產業發展自治條例																	
俄鄧·殷艾	俄鄧.殷艾	俄鄧?殷艾	俄鄧殷艾	俄鄧‧殷艾	俄鄧議員													
鳥松仁美保民宮	保民宮																	
大寮保福宮	保福宮																	
岡山區前峰里第四公墓	前峰里第四公墓																	
國防部軍備局生產製造中心第205廠	前鎮二○五兵工廠	第205廠	第二零五廠															
輕軌前鎮之星站	前鎮之星站																	
高雄市立圖書館前鎮分館	前鎮圖書館																	
總統府新南向政策辦公室	南向政策辦公室																	
南星計畫遊艇產業園區	南星計畫遊艇專區																	
南區毒災應變諮詢中心	南區毒災中心																	
勞委會南區勞動檢查所	南區勞檢所																	
高雄市南區資源回收廠	南區焚化廠	南區資源回收廠	南區資源回收廠焚化爐	高雄市焚化爐南區廠														
南部反空污大聯盟	南部反空汙大聯盟																	
南部國際機場	南部國家國際機場																	
哈瑪星生態交通示範區	哈瑪星示範區																	
鼓山輪渡站	哈瑪星渡船場	哈瑪星渡輪站	鼓山渡輪站															
哈瑪星台灣鐵道館	哈瑪星鐵道文物館																	
姚立明	姚立民																	
高雄市客家文化事務基金會	客家文化事務基金會	客家基金會																
高雄市客家文物館	客家文物館	高雄市客屬文物館	高雄市新客家文化園區文物館															
高雄市客屬美濃同鄉會	客屬美濃同鄉會																	
室內空氣品質管理法	室內空氣品質管制法																	
高級中等學校建教合作實施及建教生權益保障法	建教生權益保障法																	
高雄市建築開發商業同業公會	建築公會																	
高雄市建築師公會	建築師公會	高雄建築師公會																
高雄市建築經營協會	建築經營協會	高雄建築經營協會																
建築法	建築管理法																	
高雄律師公會	律師公會																	
後庄靈霄寶殿天公廟	後庄天公廟																	
後庄車站	後庄火車站																	
後勁反五輕運動	後勁反五輕																	
後勁社會福利基金會	後勁社區福利基金會	後勁社會基金會	後勁社福基金會	後勁基金會	後勁福利基金會													
高雄市楠梓區後勁活動中心	後勁活動中心																	
楠梓分局後勁派出所	後勁派出所																	
日月光汙染與後勁溪流域工業汙染處置	後勁溪流域工業汙染處置																	
後勁廟產管理委員會	後勁廟產管委會																	
高雄市後備指揮部	後備指揮部																	
高雄捷運後驛站	後驛車站	後驛站																
政治檔案條例	政治檔案法																	
行政院南部服務中心	政院南服中心																	
星雲法師	星雲大法師																	
林園分局昭明派出所	昭明派出所																	
柯文哲	柯p																	
洪秀柱	柱姊	柱姐	柱柱姐															
高雄市毒品防制基金會	毒品防制基金會																	
洪仲丘	洪仲秋																	
洪平朗議員服務處	洪議員平朗服務處																	
高雄港洲際貨櫃中心	洲際貨櫃中心	洲際貨櫃碼頭	洲際碼頭	高雄洲際貨櫃中心														
高雄市流行音樂中心	流行音樂中心																	
高雄市流浪動物保育協會	流浪動物保育協會																	
流域綜合治理特別條例草案	流域綜合治裡特別條例草案																	
高雄市研究發展考核委員會	研究發展考核委員會																	
國立科學工藝博物館	科工館	高雄科工館	國立科工館	國立高雄科學工藝館														
美濃文創中心	美濃文化創意園區																	
美濃愛鄉協進會	美濃愛鄉協會																	
美麗島大道管理自治條例	美麗島大道自治條例																	
美麗島捷運站	美麗島車站																	
打狗英國領事館文化園區	英國領事館文化園區	英國領事館園區																
茂林得樂日嘎大橋	茂林得樂日嘎橋																	
茄萣區公兒3-1公園	茄萣3-1兒童公園	茄萣公兒3-1公園																
茄萣烏魚文化節	茄萣烏魚節																	
食品安全衛生管理法	食安法																	
高雄市原住民故事館	原民故事館																	
原住民族文化事業基金會	原住民基金會																	
原住民族教育法	原住民教育法																	
唐榮公司企業工會	唐榮工會																	
家扶基金會	家扶																	
高雄市家長教育改革協會	家長教育改革協會																	
高雄市高級中等以下學校家長會設置自治條例	家長會設置自治條例草案																	
家緣農產品生產合作社	家緣農產品合作社																	
展昭國際企業	展昭國際																	
時代力量黨團	時力黨團																	
時報周刊	時報週刊																	
第三核能發電廠	核三電廠	核三廠																
高雄市議會氣候變遷專案小組	氣候變遷小組	議會氣候變遷小組	高雄市議會氣候變遷小組															
海巡署海岸巡防總局南部地區巡防局	海巡署南巡局	海巡署南部地區巡防局																
高雄市海洋事務推廣協會	海洋事務推廣協會																	
海霸王企業集團	海霸王	海霸王國際企業集團	海霸王集團															
消費者保護法	消保法																	
行政院消費者保護處	消保處																	
行政院消費者保護會	消保會																	
消費者文教基金會	消基會	消費者基金會																
烏山頂泥火山地景自然保留區	烏山頂泥火山自然保留區																	
翁園兒童公園	翁園3-2兒童公園																	
新草衙地區土地處理自治條例	草衙自治條例	新草衙土地處理自治條例	新草衙自治條例															
高雄市立圖書館草衙分館	草衙圖書分館	草衙圖書館																
財團法人金屬工業研究發展中心	財團法人金屬工業研究中心																	
酒駕防制自治條例	酒醉防制自治條例	酒駕防治自治條例																
臺灣酒駕防制社會關懷協會	酒駕協會																	
高雄市除草劑管理自治條例	除草劑使用管理自治條例	除草劑管理自治條例																
馬王政爭	馬王之爭																	
反馬頭山事業廢棄物掩埋場自救會	馬頭山自救會	馬頭山廢棄物掩埋場自救會																
高雄市二二八關懷協會	高市228關懷協會	高市二二八關懷協會																
高雄市1999話務中心	高市一九九九話務中心																	
高雄市731氣爆事件	高市七三一氣爆事件																	
高雄市三民區聖興會	高市三民區聖興會																	
高雄市大公陸橋	高市大公陸橋																	
高雄市大同醫院	高市大同醫院																	
高雄市大社工業區中纖公司	高市大社工業區中纖公司																	
高雄市大社工業區國喬公司	高市大社工業區國喬公司																	
高雄市女性權益促進會	高市女性權益促進會																	
高雄市市立小型學校永續發展自治條例	高市小型學校永續發展自治條例																	
高雄市中央公園	高市中央公園																	
高雄市公共停車場管理自治條例	高市公共停車場管理自治條例	停車場管理條例																
高雄市公園管理自治條例	高市公園管理自治條例																	
高雄市心家長協會	高市心家長協會																	
高雄市牙醫師公會	高市牙醫師公會																	
高雄市幼兒托育職業工會	高市幼兒托育職業工會																	
高雄市永安區興達電廠	高市永安區興達電廠																	
高雄市立小港醫院	高市立小港醫院	高醫體系小港醫院																
高雄市印尼姐妹會	高市印尼姐妹會																	
高雄市各級學校家長協會	高市各級學校家長協會	高雄市家長協會																
高雄市地檢署	高市地檢署																	
高雄市污水下水道管理自治條例	高市污水下水道管理自治條例																	
高雄市佛教會	高市佛教會																	
高雄市兵役節表揚大會	高市兵役節表揚大會																	
高雄市私立普門中學	高市私立普門中學																	
高雄市身心障礙團體	高市身心障礙團體																	
高雄市府治安會報	高市府治安會報																	
高雄市府組織自治條例	高市府組織自治條例																	
高雄市林園區水產養殖發展協會	高市林園區水產養殖發展協會																	
高雄市社福慈善團體聯合會	高市社福慈善團體聯合會																	
高雄市長期照護機構聯合協會	高市長期照護機構聯合協會																	
高雄市青果商業同業公會	高市青果公會																	
高雄市建築發展協會	高市建築發展協會																	
高雄市砂石商業同業公會	高市砂石公會																	
高雄市苓雅區忠孝公園	高市苓雅區忠孝公園																	
高雄市家事服務業職業工會	高市家事服務業職業工會																	
高雄市家長協會	高市家長協會																	
高雄市家長關懷教育協會	高市家長關懷教育協會																	
高雄市旅行商業同業公會	高市旅行公會	高雄市旅行公會																
高雄市旅館商業同業公會	高市旅館公會																	
高雄市商店街區管理輔導自治條例	高市商店街自治條例																	
高雄市商店經營發展協會	高市商店經營發展協會																	
高雄市國軍眷村文化發展協會	高市國軍眷村文化發展協會	高雄市國軍眷村發展協會	高雄市眷村文化發展協會	眷村文化發展協會	眷村協會													
高雄市基地台自治條例	高市基地台自治條例																	
高雄市婦女會	高市婦女會	高雄婦女會																
高雄市教育產業工會	高市教育產業工會	高雄市教育工會	高雄市教育公會	高雄市教育產業公會	教育產業工會													
高雄市教師產業工會	高市教師產業工會																	
高雄市教師職業工會	高市教師職業工會	高雄市教師工會	高雄市教師產業工會	高雄市教師職業公會	高雄市職業教師工會													
高雄市野鳥學會	高市野鳥學會	高雄市野鳥協會	高雄野鳥學會	高雄鳥會														
高雄市勞工博物館	高市勞工博物館	勞工博物館																
高雄市測速照相器設置管理自治條例	高市測速照相器設置管理自治條例																	
高雄市港都水上救生協會	高市港都水上救生協會	港都水上救生協會																
高雄市華德福教育協會	高市華德福教育協會																	
高雄市越南同鄉會	高市越南同鄉會																	
高雄市集中市場零售攤販職業工會	高市集中市場零售攤販職業工會																	
高雄市嗡嗡嗡動保協會	高市嗡嗡嗡動保協會	嗡嗡嗡動保協會																
高雄市愛心手足慈善會	高市愛心手足慈善會	愛心手足慈善會																
高雄市慈善團體聯合總會	高市慈善團體聯合總會	高雄市慈善團體聯合協會	高雄市慈善團體聯合會	慈善團體聯合總會	慈善總會													
高雄市新客家文化園區	高市新客家文化園區	高雄客家文化園區																
高雄市新發大橋	高市新發大橋																	
高雄市會計師公會	高市會計師公會																	
高雄市瑞生醫院	高市瑞生醫院																	
高雄市農會	高市農會	高雄農會																
高雄市道教會	高市道教會	高雄道教會																
高雄市電子機械加工業職業工會	高市電子機械加工業職業工會																	
高雄市壽山動物園	高市壽山動物園	高雄市動物園																
高雄市旗津區	高市旗津	高市旗津區	高雄旗津															
高雄市旗津風車公園	高市旗津風車公園																	
高雄市鳳山區里長聯誼會	高市鳳山區里長聯誼會																	
高雄市鳳山就業服務站	高市鳳山就業服務站																	
高雄市廢棄物商業同業公會	高市廢棄物商業同業公會																	
高雄市機械總工會	高市機械總工會																	
高雄市燕巢動物保護關愛園區	高市燕巢動物保護關愛園區	高雄市動物保護關愛園區	高雄市燕巢動物保護觀愛園區															
高雄市獨立總工會	高市獨立總工會	高雄獨立總工會																
高雄市營養師公會	高市營養師公會																	
高雄市總工會	高市總工會	高雄總工會																
高雄市聯立建設公司	高市聯立建設公司																	
高雄市駿德貿易公司	高市駿德貿易公司																	
高雄市醫師公會	高市醫師公會																	
高雄市寵物商業同業公會	高市寵物商業同業公會																	
高雄市爆竹煙火施放管制自治條例	高市爆竹煙火施放管制自治條例	爆竹煙火施放管制自治條例																
高雄市獸醫師公會	高市獸醫師公會	獸醫師公會																
高雄市藝文團體理事長協會	高市藝文團體理事長協會																	
高雄市藥師公會	高市藥師公會	高雄藥師公會																
高雄市關懷台籍老兵文化協會	高市關懷台籍老兵文化協會																	
高雄市關懷身心障礙者就業協進會	高市關懷身心障礙者就業協進會																	
高雄市關懷流浪動物協會	高市關懷流浪動物協會	關懷流浪動物協會																
高雄市關懷街友協會	高市關懷街友協會																	
高雄市護樹護地協會	高市護樹護地協會	高雄護樹護地協會																
高雄市觀光協會	高市觀光協會	觀光協會																
高屏國際機場	高屏國際大機場																	
高屏溪水質水量保護區	高屏溪水質水量保育區																	
高屏溪自然生態公園	高屏溪生態公園																	
高苑科技大學	高苑科大																	
高雄捷運大東站	高捷大東站																	
高雄捷運中央公園站	高捷中央公園站																	
高雄捷運生態園區站	高捷生態園區站	捷運生態站																
高雄捷運凱旋站	高捷紅線凱旋站	凱旋站	凱旋捷運站															
高雄捷運鳳山西站	高捷鳳山西站	高捷橘線O11鳳山西站																
高雄捷運鳳山站	高捷鳳山站																	
高雄捷運鹽埕埔站	高捷鹽埕埔站																	
高雄軟體園區	高軟園區	高雄科技園區	高雄軟體科技園區															
高軟鴻海雲端研發大樓	高軟鴻海大樓																	
高雄港區土地開發股份有限公司	高港土開公司	高雄港土地開發公司	高雄港區土地開發公司	高雄港區開發公司														
高雄港埠旅運中心	高港旅運中心	高雄市港務大樓	高雄旅運中心	高雄港旅運大樓	高雄港務旅運中心	高雄港國際旅運中心	高雄港國際港埠旅運中心	港務旅運中心	港埠旅運中心									
高雄二二八事件	高雄228事件	高雄市二二八事件																
高雄MIT國際遊艇展	高雄MIT遊艇展																	
高雄市人權學堂	高雄人權學堂																	
強冠公司	高雄大廠強冠公司																	
高雄蔡英文競選總部	高雄小英競選總部																	
高雄小港機場	高雄小港國際機場	高雄市機場	高雄南部國際機場	高雄航空站	高雄機場													
中國鋼鐵股份有限公司	高雄中鋼																	
高雄世界運動會	高雄世運會																	
高雄市出版商業同業公會	高雄出版商業同業公會																	
高雄加工出口區	高雄加工區																	
高雄氣爆自救會	高雄市七三一氣爆自救會	高雄市八一氣爆自救會																
小港國際機場	高雄市小港國際機場																	
高雄市不動產代銷經紀商業同業公會	高雄市不動產代銷公會																	
高雄市不動產建築開發商業同業公會	高雄市不動產建築開發公會																	
高雄市不動產開發商業同業公會	高雄市不動產商業公會	高雄市不動產開發公會	高雄市不動產開發商業公會															
臺灣高雄地方檢察署	高雄市地檢署	高雄地方檢察署	高雄地檢署	雄檢	雄檢署													
高雄市體育會帆船委員會	高雄市帆船委員會																	
高雄市汙水下水道使用費徵收辦法	高雄市污水下水道使用費徵收辦法																	
高雄市汙水下水道使用管理自治條例	高雄市污水下水道使用管理自治條例	高雄市污水下水道管理自治條例																
高雄市體育會羽球委員會	高雄市羽球委員會																	
高雄市自強國際同濟會	高雄市自強同濟會																	
高雄市政府兩岸小組	高雄市兩岸工作小組																	
高雄長庚紀念醫院	高雄市長庚醫院	高雄長庚	高雄長庚醫院	高雄長庚醫醫院														
高雄市長期照顧發展協會	高雄市長照協會																	
高雄市青果商業公會	高雄市青果公會																	
高雄市既有工業管線管理維護辦法	高雄市既有工業管線維護辦法																	
高雄市毒品防制事務基金會	高雄市毒品防制基金會																	
高雄市各級學校家長會長協會	高雄市家長會長協會																	
高雄捐血中心	高雄市捐血中心																	
高雄市高縣眷村文化發展協會	高雄市高縣眷村文化協會																	
高雄市市區汽車客運審議會	高雄市區汽車客運審議會																	
高雄市市區道路管理自治條例	高雄市區道路管理自治條例	高雄市道路管理自治條例	高雄道路自治條例	道路管理自治條例	道路管理條例													
高雄市政府國土計畫審議會	高雄市國土計畫審議委員會																	
高雄市議會國民外交促進會	高雄市國民外交促進會	國民外交促進會																
財政部高雄國稅局	高雄市國稅局	高雄國稅局																
高雄市高雄國際青年商會	高雄市國際青年商會																	
高雄市冠君國際同濟會	高雄市國際冠君同濟會																	
高雄市政府社會局婦女館	高雄市婦女館	婦女館																
高雄市政府社會局婦幼青少年活動中心	高雄市婦幼青少年活動中心	婦幼青少年中心	婦幼青少年活動中心	婦幼青少年館	婦幼館													
高雄市政府社會局婦幼青少年館	高雄市婦幼青少年館																	
中華民國婦女聯合會高雄分會	高雄市婦聯會																	
高雄市婦女權益促進委員會	高雄市婦權會																	
高雄市政府採購申訴審議委員會	高雄市採購申訴審議委員會																	
高雄市政府教育局軍訓室	高雄市教育局軍訓室																	
高雄市政府教育審議委員會	高雄市教育審議會																	
高雄市國民中小學教師舞團	高雄市教師舞蹈團																	
高雄市晚晴婦女協會	高雄市晚晴協會																	
高雄市郭姓宗親會	高雄市郭氏宗親會																	
高雄市城鄉發展及都市更新基金收支管理及運用自治條例	高雄市都市更新基金收支管理及運用自治條例																	
高雄市鳥松區農會	高雄市鳥松農會																	
勞工公園假日花市	高雄市勞工花市	勞工花市																
中華民國全國勞工團結總會	高雄市勞工團結總會																	
高雄市弱勢單親家庭扶助辦法	高雄市單親家庭扶助辦法																	
高雄市體育會游泳委員會	高雄市游泳委員會																	
高雄市政府登革熱工作小組	高雄市登革熱工作小組																	
高雄市結構工程工業技師公會	高雄市結構工程技師公會	高雄市結構公會	高雄市結構技師公會	高雄結構技師公會	結構技師公會													
高雄市愛樂文化藝術基金會	高雄市愛樂基金會	愛樂基金會																
高雄市私立慈暉關懷學園	高雄市慈暉關懷學園																	
高雄市政府搜救犬馴養中心	高雄市搜救犬馴養中心	高雄搜救犬馴養中心	搜救犬馴養中心															
高雄市新住民家庭服務中心	高雄市新住民中心	高雄新移民家庭中心	新住民服務中心	新住民家庭中心	新住民家庭服務中心													
高雄市立圖書館總館	高雄市新圖書館總館	高雄市新圖書總館	高雄市圖書館總館	高雄市圖書總館	高雄市圖總館	高雄圖書總館	高雄市圖書館	高雄圖書館	高市圖									
高雄市新聞局	高雄市新聞處																	
高雄市楠梓污水處理廠	高雄市楠梓汙水處理廠	高雄市楠梓污水廠																
高雄市既有工業管線管理技術委員會	高雄市經發局工業管線管理技術委員會																	
高雄市政府經濟發展局市場管理處	高雄市經發局市場管理處																	
義大國際中學國小部	高雄市義大國際小學																	
高雄市義勇消防總隊	高雄市義消總隊																	
高雄市義勇警察大隊	高雄市義警大隊																	
高雄聖徒職業籃球隊	高雄市聖徒隊																	
高雄市補習教育暨品保協會	高雄市補教協會																	
臺灣高雄農田水利會	高雄市農田水利會	高雄農田水利會																
高雄道德院	高雄市道德院																	
高雄市電腦商業同業公會	高雄市電腦公會																	
高雄市電器商業同業公會	高雄市電器公會																	
高雄市壽山動物園動物認養辦法	高雄市壽山動物園認養辦法																	
高雄市旗山區	高雄市旗山	高雄旗山	高雄旗山區															
高雄市政府鳳山行政中心	高雄市鳳山行政中心	鳳山行政中心																
高雄市廣告物管理自治條例	高雄市廣告管理自治條例																	
高雄市政府文化局影視發展暨拍片支援中心	高雄市影視發展暨拍片支援中心																	
高雄市私立樂仁啟智中心	高雄市樂仁啟智中心																	
高雄市獎勵及補償民眾拘捕人犯自治條例	高雄市獎勵及補償民眾拘捕人犯自治條例草案																	
高雄市獎勵會議展覽活動實施辦法	高雄市獎勵國際會展補助自治條例																	
高雄市政府衛生局疾病管制處	高雄市衛生局疾管處																	
法務部調查局高雄市調查處	高雄市調查站	高雄市調查處	高雄市調處	調查局高雄市調查處	調查局高雄市調處													
高雄市輪船股份有限公司	高雄市輪船公司	高雄輪船公司																
高雄市樹石藝術協會	高雄市樹石協會																	
高雄市樹德家商樂儀舞旗隊	高雄市樹德家商樂舞旗隊																	
高雄市長青社區關懷服務隊	高雄市獨居關懷隊																	
高雄市糕餅糖?業職業工會	高雄市糕餅公會																	
高雄縣市合併	高雄市縣市合併																	
高雄市餐飲職業工會	高雄市餐飲工會																	
高雄市彌陀區	高雄市彌陀	高雄彌陀																
高雄市政府環境保護局局長	高雄市環保局長																	
高雄市政府聯合服務中心	高雄市聯合服務中心																	
高雄市體育會慢速壘球委員會	高雄市壘球委員會																	
高雄市醫療器材商業同業公會	高雄市醫療器材公會																	
高雄市寶山國小	高雄市寶山實驗學校																	
高雄市六龜區寶來社區發展協會	高雄市寶來社區發展協會																	
高雄市體育會籃球委員會	高雄市籃球委員會																	
高雄市政府警察局局長	高雄市警局長	高雄市警察局長																
高雄市政府警察局鳳山第二分局	高雄市警察局鳳山第二分局																	
高雄市議會總務組	高雄市議會總務室																	
高雄市攝影學會會員聯展	高雄市攝影學會會員作品聯展																	
高雄市政府運動發展局工會	高雄市體育處工會																	
高雄市體育會足球委員會	高雄市體育會足委會																	
高雄市政府觀光局局長	高雄市觀光局長																	
高雄市觀光旅館商業同業公會	高雄市觀光旅館公會																	
大高雄市觀光商圈總會	高雄市觀光商圈總會	高雄商圈總會	高雄觀光商圈總會															
高雄市政府警察局觀光騎警隊	高雄市觀光騎警隊																	
高雄正義股份有限公司	高雄正義公司																	
高雄市永安區	高雄永安	高雄永安區																
高雄市田寮區	高雄田寮	高雄田寮區																
高雄縣田寮鄉	高雄田寮鄉	高雄縣田寮																
高雄石化氣爆事件	高雄石化大氣爆案	高雄石化氣爆	高雄石化氣爆案															
高雄石化氣爆復建週年紀念專刊	高雄石化氣爆復建週年專刊																	
高雄市立法委員	高雄立委																	
吉祥物PK賽	高雄吉祥物競賽																	
臺灣高雄地方法院	高雄地方法院	高雄地院																
高雄橋頭竹林公園網球場	高雄竹林網球場																	
高雄港自由貿易港區	高雄自由貿易港區																	
台灣自來水公司高雄服務所	高雄自來水公司																	
高雄自動化工業展	高雄自動化重工業展																	
高雄高等行政法院	高雄行政法院																	
大高雄佛教會	高雄佛教會																	
高雄區農業改良場	高雄改良場	高雄區農改場	農改場															
高雄汽車客運股份有限公司	高雄汽車客運	高雄汽車客運公司																
見證228	高雄見證二二八																	
高雄市身心障礙輪椅網球推廣協會	高雄身心障礙輪椅網球協會	高雄輪網協會																
高雄市兒童合唱團	高雄兒童合唱團																	
高雄市岡山區	高雄岡山	高雄岡山區																
高雄岡山吉發企業社	高雄岡山吉發企業																	
高雄左營明德新村	高雄明德新村																	
高雄市林園區	高雄林園	高雄林園區																
高雄果菜運銷股份有限公司	高雄果菜公司	高雄果菜運銷公司																
高雄果貿社區	高雄果貿																	
高雄物產館台中展示店	高雄物產館臺中店																	
高雄市空氣品質	高雄空品																	
高雄國際花卉股份有限公司	高雄花卉公司	高雄國際花卉公司																
高雄國際花卉市場	高雄花卉市場																	
高雄金融科技創新園區	高雄金融科技園區																	
高雄金鑽觀光夜市	高雄金鑽夜市																	
高雄市阿蓮區	高雄阿蓮																	
中國國民黨高雄市青工總會	高雄青工總會																	
高雄國際青年商會	高雄青商會	高雄國際青商會																
高雄市前金區	高雄前金																	
高雄市前鎮區	高雄前鎮																	
高雄籬仔內代天院	高雄前鎮代天院																	
高雄市南台灣總工會	高雄南台灣總工會																	
南部科學園區高雄園區	高雄南科高雄園區	高雄科學園區																
高雄市南區資源回收焚化廠	高雄南區焚化廠																	
高雄城市商品C.A.D品牌認證標章徵件暨展覽活動	高雄城市商品CAD品牌認證標章徵件活動																	
高雄客運股份有限公司	高雄客運公司																	
建台水泥高雄廠	高雄建台水泥廠																	
高雄軟體科技園區	高雄科學軟體園區	高雄軟科	軟科園區	軟體科學園區														
南部科學園區管理局	高雄科學園區管理局																	
高雄市美濃區	高雄美濃																	
高雄市美濃區農會	高雄美濃區農會	高雄縣美濃鎮農會																
高雄市茂林區	高雄茂林	高雄茂林區																
高雄市茄萣區	高雄茄萣																	
高雄厝立體綠化國際研討會	高雄厝國際研討會																	
高雄市高雄厝設計及鼓勵回饋辦法	高雄厝設計及鼓勵回饋辦法	高雄厝設計及鼓勵辦法																
高雄原住民大專學生中心	高雄原住民大專中心																	
高雄市政府社會局家庭暴力及性侵害防治中心	高雄家防中心																	
高雄展覽館股份有限公司	高雄展覽館公司																	
輕軌高雄展覽館站	高雄展覽館站																	
交通部中央氣象局高雄氣象站	高雄氣象站																	
81石化氣爆事件民間捐款專戶收支運用情形調查專案小組	高雄氣爆事件調查監督小組	專戶收支運用情形調查專案小組																
高雄氣爆紀念博物館	高雄氣爆博物館																	
國立高雄海洋科技大學	高雄海洋科大	高雄海洋科技大學	高雄海科大	高雄海專	國立海洋科技大學													
高雄海洋科技產業創新專區	高雄海洋科技產業專區	高雄海洋科技產業園區																
高雄海碩網球公開賽	高雄海碩杯網球賽事																	
財政部關務署高雄關	高雄海關	高雄關																
城市商旅真愛館	高雄真愛館																	
ICLEI高雄環境永續發展能力訓練中心	高雄能力訓練中心																	
高雄海軍航空隊	高雄航空隊																	
臺灣高等法院高雄分院	高雄高分院	高雄高等法院																
臺灣高等檢察署高雄檢察分署	高雄高分檢	高雄檢察分署																
高雄市立高雄高商	高雄高商	高雄商職																
高雄啤酒音樂節	高雄啤酒節	高雄啤酒節大會																
高雄國賓大飯店	高雄國賓	高雄國賓飯店																
高雄國際會館	高雄國際休閒會館																	
高雄國際動漫節	高雄國際動漫展																	
高雄國際會議中心	高雄國際會展中心																	
高雄國際郵輪協會	高雄國際遊輪協會																	
高雄捷運股份有限公司	高雄捷運股公司																	
高雄捷運高雄國際機場站	高雄捷運機場站																	
高雄第一科技大學	高雄第一科大																	
高雄市鳥松區	高雄鳥松	鳥松	鳥松區															
高雄港第二港口	高雄港二港口																	
高雄港洲際貨櫃中心第二期工程計畫	高雄港洲際二期工程																	
香蕉碼頭	高雄港香蕉碼頭																	
高雄港務分公司	高雄港務公司																	
內政部警政署高雄港務警察總隊	高雄港務警察總隊	高雄港警總隊																
駁二蓬萊倉庫群	高雄港蓬萊倉庫群																	
高雄港車站	高雄港驛																	
高雄市湖內區	高雄湖內區	湖內區																
高雄市湖內區田尾里	高雄湖內區田尾里																	
高雄華園大飯店	高雄華園飯店																	
高雄圓山大飯店	高雄圓山飯店																	
高雄愛河端午嘉年華暨龍舟錦標賽	高雄愛河端午龍舟錦標賽	高雄愛河龍舟賽																
高雄。愛樹人	高雄愛樹人團體																	
高雄市新興區	高雄新興區																	
高雄市楠梓區	高雄楠梓	高雄楠梓區																
高雄捷運獅甲站	高雄獅甲捷運站																	
高雄市路竹區	高雄路竹	高雄路竹區																
高雄廣播電臺	高雄電台																	
高雄市鼓山區	高雄鼓山																	
高雄市實物銀行	高雄實物銀行																	
衛生福利部旗山醫院	高雄旗山醫院	署立旗山醫院	旗山署立醫院															
高雄漢來大飯店	高雄漢來	高雄漢來飯店																
高雄福容大飯店	高雄福容飯店																	
高雄市現代化綜合體育館	高雄綜合體育館																	
高雄銀行企業工會	高雄銀行工會	高銀工會																
高雄駁二藝術特區	高雄駁二	高雄駁二特區																
高雄市鳳山區	高雄鳳山	高雄鳳山區																
高雄鳳荔文化觀光季	高雄鳳荔文化季	高雄鳳荔觀光季																
高雄市審計處處長	高雄審計處長																	
高雄澄清湖風景區	高雄澄清湖																	
衛武營國家藝術文化中心	高雄衛武營文化園區	高雄衛武營園區	衛武營國家藝文中心	衛武營國家藝術中心														
高雄市動產質借所	高雄質借所																	
高雄市養豬協會	高雄養豬協會																	
高雄市橋頭區	高雄橋頭區																	
高雄燈會藝術節全國創意花燈競賽	高雄燈會全國創意花燈競賽																	
高雄市燕巢區	高雄燕巢	高雄燕巢區																
高雄縣大社鄉	高雄縣大社																	
高雄縣大社鄉三奶村	高雄縣大社三奶村																	
高雄市大寮區	高雄縣大寮鄉																	
高雄縣大寮鄉新厝村	高雄縣大寮鄉新厝																	
大高雄中醫師公會	高雄縣中醫師公會																	
高雄縣仁武鄉	高雄縣仁武																	
高雄縣內門鄉	高雄縣內門																	
高雄縣永安鄉	高雄縣永安																	
高雄市岡山身心障礙福利服務中心	高雄縣身心障礙福利服務中心																	
高雄縣岡山鎮	高雄縣岡山																	
高雄縣長官邸	高雄縣長公館																	
高雄縣建築開發商業同業公會	高雄縣建築開發同業公會																	
高雄縣美濃鎮	高雄縣美濃																	
高雄縣鳳山市	高雄縣鳳山	高縣鳳山																
高雄縣橋頭鄉	高雄縣橋頭	高縣橋頭鄉																
高雄縣警察局	高雄縣警局																	
國立高雄應用科技大學	高雄應用大學	高雄應用科大	高應大															
高雄市立圖書館總館共構會展文創會館	高雄總圖文創會館																	
高雄醫學大學附設中和紀念醫院	高雄醫學大學附設醫院	高醫大附設醫院																
高雄藝品?有限公司	高雄藝品公司																	
財政部高雄關稅局	高雄關稅局																	
高雄市政府戀舊拍賣網	高雄戀舊網																	
高雄市體育會滑水委員會	高雄體育會滑水委員會																	
高雄市鹽埕區	高雄鹽埕	高雄鹽埕區																
高雄鹽埕教會	高雄鹽埕長老教會																	
高媽媽狗園	高媽媽流浪狗園																	
高雄縣政府	高縣府																	
高雄縣紅派	高縣紅派																	
高雄縣眷村文化發展協會	高縣眷村文化協會																	
高雄縣衛生局	高縣衛生局																	
高雄縣選委會	高縣選委會																	
高雄縣環保局	高縣環保局																	
高雄縣獸醫師公會	高縣獸醫師公會																	
國立高雄應用科技大學燕巢校區	高應大燕巢校區																	
臺灣高等檢察署	高檢署																	
高雄醫學大學登革熱防治研究中心	高醫大登革熱防治研究中心																	
高雄醫學大學附設高醫岡山醫院	高醫岡山醫院																	
高醫透明革命	高醫學運透明革命																	
台灣高鐵公司	高鐵公司																	
交通部高速鐵路工程局	高鐵局																	
偏遠地區學校教育發展條例	偏鄉學校振興條例																	
全民健康保險法	健保法																	
全民健康保險會	健保會																	
衛生福利部中央健康保險署	健保署																	
高雄市動物保護處	動物保護處	動保處	農業局動物保護處	農業局動保處														
動物保護法	動保法																	
台灣動物保護行政監督聯盟	動保監督聯盟																	
行政院農委會動植物防疫檢疫局	動植物防疫檢疫局																	
中華民國全國商業總會	商總																	
左營啟明堂	啟明堂																	
國道3號	國3																	
國土計畫法	國土法																	
內政部國土測繪中心	國土測繪中心																	
交通部臺灣區國道新建工程局	國工局	國道工程局	國道新建工程局															
孫中山	國父																	
國大代表	國代																	
國務院臺灣事務辦公室	國台辦																	
公立國民小學及國民中學委託私人辦理條例	國民中學委託私人辦理條例																	
國民身分證相片影像資料使用管理要點	國民身分證相片影像使用管理要點																	
國民健康署	國民健康局																	
中國國民黨中央委員會文化傳播委員會	國民黨中央文傳會	國民黨文傳會																
國民黨全國青工總會	國民黨青工會																	
中國國民黨高雄市委員會	國民黨高雄市委員會																	
國立原住民族博物館	國立原住民博物館	國家原住民族博物館	國家原住民博物館															
國立旗山高級農工職業學校	國立旗山農工																	
兩岸經貿文化論壇	國共論壇																	
國民住宅條例	國宅條例																	
中華民國國家安全局	國安局																	
中華民國國家安全局局長	國安局長																	
國家安全法	國安法																	
國家安全會議	國安會																	
財政部國有財產署	國有財產局	國有財產署	國產署															
財政部國有財產局組織條例	國有財產局管理條例																	
立法院外交及國防委員會	國防委員會																	
中華民國國防部	國防部																	
中華民國國防部部長	國防部長																	
國林號開發股份有限公司	國林號公司																	
國家表演藝術中心	國表藝中心	國家藝術表演中心																
國城建設	國城																	
國家實驗研究院	國研院																	
國軍人才招募中心	國軍招募中心																	
國軍退除役官兵輔導條例	國軍退除役輔導條例																	
國家公園管理處組織準則	國家公園管理處組織法																	
國家文化藝術基金會	國家文藝基金會																	
國家地震工程研究中心	國家地震中心																	
總統府國家年金改革委員會	國家年金改革委員會																	
國家蚊媒研究防治專責機構	國家蚊媒研究防治專制機構																	
國家蚊媒傳染病防治研究中心	國家蚊媒傳染病防制中心																	
中華民國國家通訊傳播委員會	國家通信傳播委員會	國家通訊傳播委員會																
國家圖書館南部分館	國家圖書館南館																	
國家課程發展委員會	國家課程委員會																	
交通部觀光局	國家觀光局																	
中央銀行國庫局	國庫局																	
財政部國庫署	國庫署																	
國泰世華銀行	國泰世華																	
高雄鳳山國泰花市	國泰花市																	
行政院衛生署國民健康局	國健局																	
國務機要費案	國務費案																	
國家教育研究院	國教院																	
國民基本教育課程研究發展會	國教基本教育課程研究會																	
教育部國民及學前教育署	國教署																	
國喬石油化學股份有限公司	國喬	國喬石化																
國家發展研究院	國發院																	
國家發展基金	國發基金																	
經濟部國際貿易局	國貿局	國際貿易局	經濟部國貿局															
內政部警政署國道公路警察局	國道公路警察局	國道警察局																
國道公路建設管理基金	國道建設基金	國道基金																
國賓大飯店	國賓飯店																	
芙彤盃國際女子棒球邀請賽	國際女子棒球邀請賽																	
台北國際自行車展覽會	國際台北自行車展																	
台灣國際扣件展覽會	國際扣件展覽																	
高雄市立圖書總館國際繪本中心	國際兒童繪本中心																	
國際法院	國際法庭																	
高雄國際食品展	國際食品展																	
中華國際會議展覽協會	國際展覽協會																	
國際書展暨蔬食博覽會	國際書展和蔬食博覽會																	
聯合國海洋法公約	國際海洋公約																	
高雄市國際商工高級中等學校	國際商工																	
國際貨幣基金組織	國際貨幣基金																	
國際創新創業發展協會	國際創新創業協會																	
國際單項運動總會聯合會	國際單項運動總會																	
世界棒壘球聯盟	國際棒球總會																	
國際視障運動總會	國際視障總會																	
中華民國滑輪溜冰協會	國際滑輪溜冰總會																	
國際圖書館協會聯盟	國際圖書館協會聯合會	國際圖書館學會聯盟																
國慶日	國慶																	
國慶旅行社有限公司	國慶旅行社																	
國慶籌備委員會	國慶籌委會	國慶籌備會																
國家衛生研究院	國衛院																	
國家賠償事件處理審議會	國賠會	國賠審議委員會																
國營事業管理法	國營事業管理辦法																	
經濟部國營事業委員會	國營會	經濟部國營會																
法務部矯正署臺中監獄附設培德醫院	培德醫院																	
台灣基進	基進側翼																	
台灣基督長老教會	基督長老教會	基督教長老教會																
鹽埕堀江商場	堀江商場																	
高雄市婚姻媒合職業工會	婚姻媒合職業工會																	
高雄婦女節影展	婦女節影展																	
國民黨婦女工作會	婦工會																	
婦聯青溪分會高雄市支會	婦聯青溪高雄市支會																	
崇義文教基金會	崇義基金會																	
鳳山舊城孔子廟崇聖祠	崇聖祠																	
大樹崇聖殿張天師廟	崇聖殿																	
崑山科技大學	崑山大學	崑山科大																
大崗山風景區	崗山風景區																	
鹽埕崛江商場	崛江商場																	
康慈寵物樂園	康慈寵物園																	
康裕成議員服務處	康裕成服務處																	
康寧寵物樂園	康寧寵物園																	
張善政	張揆																	
張道禎	張道禎天師																	
強冠企業股份有限公司	強冠企業公司																	
強冠餿水油案	強冠事件																	
旗津彩虹教堂	彩虹教堂																	
悠遊卡股份有限公司	悠遊卡公司																	
悠遊卡投資控股股份有限公司	悠遊卡投控	悠遊卡投控公司	悠遊卡投資控股公司	悠遊卡控股公司														
興達港情人碼頭	情人碼頭	興達漁港情人碼頭																
高雄市大眾捷運系統土地開發基金	捷運土開基金	捷運系統土地開發基金																
高雄捷運大寮主機廠	捷運大寮主機廠																	
高雄捷運凹子底站	捷運凹仔底站																	
高雄都會區大眾捷運系統鳳山線	捷運系統鳳山線																	
高雄捷運油廠國小站	捷運油廠國小																	
大眾捷運法	捷運法																	
高雄捷運草衙站	捷運草衙車站																	
高雄捷運鳥松機廠	捷運鳥松機廠																	
高雄捷運衛武營站	捷運衛武營車站																	
高雄市教育發展基金	教育發展基金																	
美濃學園教育藝文館	教育藝文館																	
高雄市立圖書館鳳山曹公分館	曹公分館																	
曹公廟	曹公祠																	
梅健華	梅建華																	
高雄市政府警察局六龜分局梅蘭派出所	梅蘭派出所																	
高雄市梓官區	梓官	梓官區																
梓官老人日間照顧中心	梓官老人日照中心																	
梓官區典寶橋	梓官典寶橋																	
梓官區蚵仔寮觀光漁港	梓官蚵仔寮漁港																	
高雄縣梓官鄉	梓官鄉																	
梓官區農會	梓官農會																	
梓官區漁會	梓官漁會																	
涼山特勤隊	涼山部隊																	
淡江大學	淡大																	
高雄市私立淨覺社會福利基金會	淨覺基金會																	
清華大學	清大	清華																
左營洲仔清水宮	清水宮																	
六班長清庄事件	清庄事件																	
頂濃清奉宮	清奉宮																	
楠梓土庫清福寺	清福寺																	
楠梓清豐棒球場	清豐球場																	
高雄市現代畫學會	現代畫學會																	
理律法律事務所	理律事務所																	
產業創新條例	產創條例																	
台灣產業發展策進會	產業發展策進會																	
盛貽綠能科技股份有限公司	盛貽綠能科技																	
國軍老舊眷村改建條例	眷改條例	眷村改建條例																
再見捌捌陸-臺灣眷村文化園區	眷村文化園區																	
高雄市眷村文化節	眷村文化節																	
軍眷服務處	眷服處																	
台灣第一民族黨	第一民族黨																	
國際海事展	海事展																	
高雄市第一社區大學	第一社區大學																	
國立高雄第一科技大學	第一科大	第一科技大學																
陸軍第八軍團指揮部	第八軍團指揮部																	
世界夏季特殊奧林匹克運動會	世界特殊奧運會																	
宗教與心靈改革學術研討會	宗教與心靈改革研討會																	
港都聯合助學暨展翅工程服務方案相見歡活動	港都聯合助學相見歡																	
OPEN!大氣球遊行	高雄大氣球遊行																	
第三區養護工程處	第三工程處	第三養工處																
台灣檢驗科技股份有限公司(SGS)	第三機構SGS																	
海巡署第五二岸巡大隊	第五二岸巡大隊																	
行政院海岸巡防署南部地區巡防局岸巡第五總隊	第五岸巡總隊																	
高雄港第五貨櫃中心	第五貨櫃中心																	
和家盃排球錦標賽	和家盃																	
高雄港第六貨櫃中心	第六貨櫃中心																	
第崴實業股份有限公司	第崴實業	第崴實業公司																
統一7-ELEVEn獅隊	統一獅隊																	
時代大道	統一夢時代大道																	
中華統一促進黨	統促黨																	
高雄市大樹區統嶺社區發展協會	統嶺社區發展協會																	
統聯客運	統聯																	
一號船渠景觀橋樑	船渠景觀橋																	
阿姆斯特丹史基浦機場	荷蘭史基浦機場																	
高雄市莊朱玉女慈善會	莊朱玉女慈善會																	
莫拉克颱風	莫拉克																	
莫拉克風災	莫拉克八八風災																	
蚵仔寮	蚵子寮																	
蚵仔寮朝天宮	蚵子寮朝天宮																	
蚵仔寮近海漁業特定區	蚵仔寮特定區																	
中華民國設計師協會	設計師協會																	
許至椿	許至樁																	
許福明	許福民																	
蚵子寮通安宮	通安宮																	
高雄市原住民族部落大學	部落大學																	
世界郭氏宗親總會	郭氏宗親會	郭氏宗親總會																
郭台銘	郭董																	
都市計畫法	都計法																	
高雄市政府都市發展局局長	都發局長																	
野百合學運	野百合	野百合學生運動																
野柳地質公園	野柳																	
野設計製造所	野設計?製造所																	
臺灣野鳥保育協會	野鳥保育協會																	
陳中和翁慈善基金會	陳中和基金會																	
陳宜民	陳宜民立委																	
陳啟川先生文教基金會	陳啟川文教基金會																	
陳詩鍾	陳詩鐘																	
陳樹菊	陳嬤陳樹菊																	
中美貿易戰	陸美貿易大戰																	
中華民國陸軍	陸軍																	
鳳山陸軍步兵學校	陸軍步校																	
中華民國陸軍軍官學校	陸軍官校	黃埔軍校																
陸軍訓練作戰發展司令部	陸訓部																	
陸淑美議員服務處	陸淑美服務處																	
中華民國海軍陸戰隊	陸戰隊																	
頂好超市	頂好																	
頂茄萣賜福宮	賜福宮																	
林園頂厝北極殿靈聖堂	頂厝橋北極殿靈聖堂																	
大武?頂荖濃太祖祭典	頂荖濃平埔祭典																	
頂新國際集團	頂新	頂新公司	頂新集團															
頂新劣油風暴	頂新風暴	頂新飼料油案																
頂新製油實業股份有限公司	頂新製油																	
高雄市鳥松區戶政事務所	鳥松戶政事務所																	
捷運鳥松機廠	鳥松捷運機廠																	
鳥松就業服務台	鳥松就服台																	
高雄縣鳥松鄉	鳥松鄉																	
高雄縣鳥松鄉公所	鳥松鄉公所																	
鳥松區農會	鳥松農會																	
高雄市立圖書館鳥松分館	鳥松圖書館																	
高雄市鳥松區衛生所	鳥松衛生所																	
台東鹿鳴溫泉酒店	鹿鳴酒店																	
傅?萁	傅昆萁																	
傅爾布萊特計畫	傅爾布萊特																	
傑太日菸	傑太日煙																	
傑迪斯整合行銷公司	傑迪斯行銷公司																	
高雄輕軌凱旋中華站	凱旋中華站																	
凱旋陸橋	凱旋路橋																	
凱景實業股份有限公司	凱景實業	凱景實業公司																
創世社會福利基金會	創世基金會	創世福利基金會																
創世基金會鳳山分會	創世鳳山分院																	
創舞極致跨域國際東方舞團	創舞極致舞團																	
台灣創價學會	創價學會																	
勝一化工股份有限公司	勝一	勝一化工																
高雄市政府勞工局長	勞工局長																	
高雄市勞工服務中心	勞工服務中心																	
勞動部勞工保險局	勞工保險局																	
職業災害勞工保護法	勞工保護法	職災保護法	職業災害保護法															
勞工教育生活中心澄清會館	勞工教育生活中心澄清湖館																	
中華民國勞動部	勞委會	勞動部																
勞工保險局高雄市辦事處	勞保局高雄分署																	
勞工保險條例	勞保條例																	
勞工退休基金	勞退基金																	
台灣勞工陣線	勞陣																	
勞動基準法	勞基法																	
勞動力發展署	勞發署																	
中華民國勞資關係協進會	勞資關係協進會																	
高雄市政府勞工局勞動檢查處處長	勞檢處長																	
喜事達家具股份有限公司	喜事達家具																	
高雄中正路喜餅街	喜餅街																	
喜樂島聯盟	喜樂島																	
喜憨兒社會福利基金會	喜憨兒基金會	喜憨兒福利基金會																
富士康科技集團	富士康																	
日本富山縣議會	富山市議會																	
富比士	富比世																	
高雄市政府社會局富民長青中心	富民長青中心	富民長青活動中心																
富民長青中心暨育兒資源中心	富民長青育兒中心																	
富味鄉食品股份有限公司	富味鄉公司																	
富樂夢股份有限公司	富樂夢公司																	
富駿事業股份有限公司	富駿公司	富駿有限公司	富駿廢棄物處理公司															
寒軒國際大飯店	寒軒	寒軒大飯店																
寒軒和平店	寒軒大飯店和平店																	
寒軒陽明飯店	寒軒陽明店																	
尊懷文教基金會	尊懷文教基金	尊懷基金會																
彭婉如文教基金會	彭婉如基金會																	
高雄市阿蓮區復安社區	復安社區																	
六龜區復興二橋	復興二橋																	
高雄市復興國小棒球隊	復興少棒																	
復興航空	復興航空公司																	
基督教中華循理會	循理會																	
惠州台灣精品博覽會	惠州台灣精品展																	
高雄市惠急慈善會	惠急慈善會																	
高雄市援中沿海漁民促進會	援中漁民促進會																	
普悠瑪列車	普悠瑪																	
東京晴空塔	晴空塔																	
智冠科技股份有限公司	智冠	智冠科技																
智崴資訊股份有限公司	智崴	智崴資訊	智崴資訊公司															
智崴資訊科技股份有限公司	智崴資訊科技公司																	
高雄市政府交通局智慧運輸中心	智慧運輸中心																	
智慧電子產業計畫推動辦公室	智慧電子產業推動辦公室																	
智慧電動車推動辦公室	智慧電動車辦公室																	
青年暑期社區職場體驗計畫	暑期青年職場體驗計畫																	
曾麗燕議員服務處	曾麗燕服務處																	
最高法院	最高院																	
最高檢察署	最高檢																	
最高法院檢察署特別偵查組	最高檢察署特偵組																	
朝友工業股份有限公司	朝友	朝友工業																
高雄鹽埕埔朝后宮	朝后宮																	
朝宇航太科技股份有限公司	朝宇航太																	
證券投資人及期貨交易人保護法	期貨交易人保護法																	
棧貳庫KW2	棧貳庫																	
森岳整合行銷有限公司	森岳整合行銷公司																	
高雄市港友慢跑協會	港友慢跑協會																	
臺灣港務股份有限公司	港務局公司	港務局港務公司																
港埠旅運中心	港埠大樓	港埠旅運大樓																
港都汽車客運股份有限公司	港都汽車客運	港都客運	港都客運公司															
港都盃全國田徑錦標賽	港都盃田徑錦標賽																	
港都盃龍舟錦標賽	港都盃龍舟賽																	
高雄翰品酒店港都茶樓	港都茶樓																	
游錫?	游院長	游錫?游院長																
游淑慧	游淑惠																	
高雄市湖內區老人活動中心	湖內老人活動中心	湖內區老人活動中心																
高雄市湖內區農會	湖內區農會																	
高雄縣湖內鄉	湖內鄉																	
高雄縣湖內鄉公所	湖內鄉公所																	
湖東社區活動中心	湖東活動中心																	
滋豐水產資材有限公司	滋豐水產資材公司																	
無黨團結聯盟	無盟	無黨聯盟																
使用牌照稅法	牌照稅法																	
義大犀牛隊	犀牛隊																	
番薯衛星電視台	番薯電視台	蕃薯台	蕃薯電視台															
登革熱疫情中央流行疫情指揮中心	登革熱流行疫情指揮中心會議																	
短期補習班設立及管理準則	短期補習設立及管理準則																	
宜蘭國際童玩藝術節	童玩節																	
幸福童愛館	童愛館																	
橋頭筆秀天后宮	筆秀天后宮																	
紫竹寺	紫竹寺廟																	
法鼓山紫雲寺	紫雲寺																	
鳳山無極紫雲宮	紫雲宮																	
菊系五福將	菊系五福																	
華山社會福利慈善事業基金會	華山基金會																	
華山基金會橋頭愛心天使站	華山橋頭愛心天使站																	
華王大飯店	華王飯店																	
華東科技股份有限公司	華東科技																	
華信航空	華信																	
華南金控	華南金																	
高雄市華南獅子會	華南獅子會																	
瀕危野生動植物種國際貿易公約	華盛頓公約																	
中華電視公司	華視																	
華電聯網股份有限公司	華電聯網																	
華南銀行	華銀																	
台灣華德福教育協會	華德福教育協會																	
華錫鈞航空工業發展基金會	華錫鈞航空工業基金會																	
颱風菲特	菲特颱風																	
菲律賓	菲國																	
世界衛生組織菸草控制框架公約	菸草控制框架公約																	
高雄市街友關懷協會	街友關懷協會																	
證券交易法	証券交易法	證交法																
高雄市貴賓計程車觀光促進協會	貴賓計程車觀光促進協會																	
黃建豪	貿友展覽公司																	
大崗山超峰寺	超峰寺																	
東森超視	超視																	
正修科技大學超微量研究科技中心	超微量中心																	
高雄市超額進用身心障礙者獎勵辦法	超額進用身心障礙者獎勵辦法																	
鳳山開漳聖王廟	開漳聖王廟																	
陽光社會福利基金會	陽光基金會																	
高雄中學棒球隊	雄中棒球隊																	
高雄高商樂旗隊	雄商樂儀隊																	
雄愛生囝仔‧FUN心育兒資源網	雄愛生囝子FUN心育兒資源網																	
高雄市雄獅慢跑協會	雄獅慢跑協會																	
高雄監獄	雄監																	
達悟族	雅美族																	
雅宴招待會所	雅宴招待所																	
集會遊行法	集遊法																	
高雄市雲林縣同鄉會	雲林同鄉會																	
雲門舞集	雲門																	
高雄市雲高慈愛會	雲高慈愛會																	
行政院雲嘉南區聯合服務中心	雲嘉南區聯合服務中心																	
高雄內門順賢宮	順賢宮																	
黃柏霖議員服務處	黃柏霖服務處																	
林園港埔黃家古厝	黃家古厝	黃家江夏古厝																
黃淑美議員服務處	黃淑美服務處																	
黃慶雲日式墓園	黃慶雲墓園																	
美濃黃蝶祭	黃蝶祭																	
台灣海峽	黑水溝																	
統一速達	黑貓宅急便																	
澄清湖水漾會館	傳習齋																	
消費者債務清理條例	債務清理條例																	
勤業眾信聯合會計師事務所	勤業眾信會計師事務所																	
建築園冶獎	園冶獎																	
鳳山熱帶園藝試驗分所	園藝試驗所																	
涂醒哲	塗醒哲																	
奧勒岡州議會	奧瑞岡州議會	俄勒岡州議會																
愛河水漾嘉年華	水漾高雄嘉年華																	
愛馨物資分享中心	愛心物資中心																	
高雄市愛加倍全人社區關懷協會	愛加倍全人社區關懷協會																	
高雄市愛河水域交通管理辦法	愛河水域管理辦法																	
高雄市音樂館	愛河音樂館																	
貢多拉船	愛河貢多拉																	
高雄市愛河學園	愛河學園																	
中華道教慈明弘道協會	慈明弘道協會																	
慈恩紀念圖書館	慈恩圖書館																	
五塊厝慈聖宮	慈聖宮																	
慈濟基金會	慈濟功德會																	
高雄市慈聯社會福利基金會	慈聯基金會																	
新光公有停車場	新光停車場																	
高雄市新移民女性關懷協會	新住民女性關懷協會																	
材料國際學院	新材料國際學院																	
新南向工作小組	新南向小組																	
新高市產業總工會	新高市總工會																	
新住民學習中心	新移民學習中心																	
台灣新移民勞動權益促進會	新移民權益促進會																	
左營新庄仔天公廟	新莊仔天公廟																	
高雄市零售市場管理自治條例	新零售市場管理自治條例																	
新境界文教基金會	新境界基金會																	
新潮流系	新潮流																	
海軍新濱營區	新濱營區																	
高雄市立圖書館楠仔坑分館	楠梓坑圖書分館																	
楠梓代天府	楠梓區代天府																	
高雄市立圖書館右昌分館	楠梓區右昌圖書館																	
後勁聖雲宮	楠梓區聖雲宮	聖雲宮																
滑輪溜冰協會	滑輪溜冰單項委員會																	
爆竹煙火管理條例	煙火條例																	
獅子頭水圳	獅子頭圳二幹線																	
戲獅甲藝術節	獅甲藝術節																	
經武陸橋	經武路橋																	
義大開發案	義大世界開發案																	
義?集團	義大集團	義聯集團																
聖功社會福利慈善基金會	聖功社會福利慈善基金會芥子園																	
萬大大橋	萬大橋																	
誠品書店	誠品書局																	
資訊工業策進會	資策會																	
路竹區老人活動中心	路竹老人活動中心																	
路竹建國公園	路竹區建國公園																	
路竹運動公園	路竹體育公園	路竹體育園區																
農16立體停車場開發案	農十六立體停車場開發案																	
農夫市集	農夫市																	
行政院農業委員會	農委會	農業委員會																
行政院農業委員會農業金融局	農委會農業金融局																	
農民健康保險條例	農保條例																	
農業發展基金	農發基金																	
農業發展條例	農發條例																	
農業天然災害救助辦法	農業天然災害辦法																	
農業用地興建農舍辦法	農業用地興建辦法																	
行政院農業委員會農業試驗所	農試所																	
行政院農業委員會農糧署	農糧署																	
行政院農業委員會農糧署南區分署	農糧署南區分署																	
交通部道安委員會	道安委員會																	
高雄市道教聯合會	道教聯合會																	
旗山鼓山公園	鼓山公園																	
哈瑪星代天宮	鼓山哈瑪星代天宮																	
高雄市立圖書館鼓山分館	鼓山圖書館																	
壽山國家自然公園	壽山公園	壽山國家公園																
壽山動物保護教育園區	壽山動保教育園區																	
?後北極殿	?后北極殿																	
旗山橋	旗山大橋																	
旗山孔子廟	旗山孔廟	旗山區孔廟																
旗山生活文化園區	旗山文化園區																	
旗山轉運站	旗山客運轉運站																	
旗山大林廢爐渣案	旗山圓潭案件	旗山轉爐石	旗山爐渣															
高雄市立圖書館旗山分館	旗山圖書分館	旗山圖書館																
旗后觀光市場	旗后市場																	
旗津中洲污水處理場	旗津中洲污水廠																	
中洲輪渡站	旗津中洲輪渡站																	
高雄港過港隧道	旗津過港隧道																	
旗津魚市場	旗津漁市場																	
榮化大社廠	榮化公司大社廠																	
高雄榮光堂	榮光堂																	
高雄榮總	榮總																	
高雄漁人碼頭	漁人碼頭																	
漢來大飯店	漢來飯店																	
那瑪夏區民權大橋	瑪雅里民權大橋																	
瑪雅吊橋	瑪雅橋																	
福山公園	福山藥用植物公園																	
福容大飯店	福容飯店																	
仁武福清宮	福清宮																	
福華大飯店	福華飯店																	
福誠高中多功能綜合運動場	福誠高中綜合運動場																	
大同福樂學堂	福樂學堂																	
高雄市綠色協會	綠色協會	環保綠色協會																
綠色和平台灣文化廣播電台	綠色和平廣播電台																	
高雄市綠建築自治條例	綠建築自治條例																	
陸軍軍官學校	維武路陸軍官校																	
維冠金龍大樓	維冠大樓																	
維新陸橋	維新橋																	
翠華高架橋	翠華陸橋																	
翠華自行車景觀橋	翠華路空中走廊																	
台灣兒童暨家庭扶助基金會	臺灣兒童暨家扶基金會																	
台灣時報	臺灣時報																	
台灣書法學會	臺灣書法學會																	
台灣電力公司	臺灣電力公司																	
高雄輕軌	輕軌																	
輕軌美術館站	輕軌美術館																	
前鎮機廠	輕軌機廠																	
遠雄企業團	遠雄集團																	
金融監督管理委員會銀行局	銀行局																	
大東公園	鳳山大東公園	鳳山區大東公園																
鳳山轉運站	鳳山大東轉運站	鳳山公車轉運站	鳳山轉運中心															
大智陸橋	鳳山大智陸橋																	
鳳山地方文化館	鳳山文化館																	
鳳山鎮南宮仙公廟	鳳山仙公廟																	
鳳山水資源中心	鳳山汙水處理廠	鳳山污水再生水廠	鳳山污水處理場	鳳山污水處理廠	鳳山溪污水處理廠													
鳳翔公園	鳳山垃圾山	鳳翔垃圾山																
高雄市老人公寓	鳳山松鶴樓	崧鶴樓																
社會局婦幼青少年活動中心	鳳山社會局婦幼館																	
鳳山國際青年商會	鳳山青商會																	
鳳山鳳邑城隍廟	鳳山城隍廟																	
新泰兒童公園	鳳山新泰公園																	
鳳山溪大智陸橋	鳳山溪大智橋																	
鳳山區農會	鳳山農會																	
鳳山運動園區	鳳山運動中心	鳳山體育園區																
鳳凌廣場	鳳山鳳凌廣場	鳳林廣場	鳳淩廣場															
鳳山體育館	鳳山體育場																	
鳳山游泳池	鳳山體育場游泳池																	
鳳東兒童公園	鳳東公園																	
鳳信有線電視	鳳信	鳳信電視																
臺灣鳳梨工廠	鳳梨工廠																	
鳳鳴廣播電台	鳳鳴電台																	
鳳鼻頭遺址	鳳鼻頭國定遺址																	
小港鳳儀宮	鳳儀宮																	
橋頭鳳橋宮	鳳橋宮媽祖廟																	
廢棄物清理法第71條	廢棄物清理法71條																	
廢棄物清理法	廢清法																	
美濃廣善堂	廣善堂																	
廣達文教基金會	廣達基金會																	
林園廣應廟	廣應廟																	
獅甲廣濟宮	廣濟宮																	
影視發展暨拍片支援中心	影視發展中心																	
德川國際旅行社	德川旅行社																	
德民新橋	德明新橋																	
慶富集團營運總部大樓	慶富大樓	慶富總部																
慶云案	慶雲案																	
樂齡學習中心	樂齡中心																	
潘恆旭	潘恒旭																	
澄瀾砲台	澄瀾炮台																	
獎勵土地所有權人辦理市地重劃辦法	獎勵所有權人辦理市地重劃辦法																	
駁二蓬萊倉庫	蓬萊倉庫																	
蓮池潭風景區管理站	蓮池潭管理站																	
蓮池潭文化觀光協會	蓮池潭觀光協會																	
高雄佛教蓮社	蓮社																	
衛生福利部食品藥物管理署	衛福部食品藥物管理署	衛福部食藥署																
衛生福利部疾病管制署	衛福部疾病管制署	衛福部疾管署																
衛生福利部醫事司	衛福部醫事司																	
高雄市調色板協會	調色板協會																	
法務部調查局	調查局																	
法務部調查局南部地區機動工作站	調查局南部地區機動工作站																	
法務部調查局航業處高雄調查站	調查局航業調查處高雄站																	
財政部賦稅署	賦稅署																	
高雄市輪船公司	輪船公司																	
高雄輪椅夢公園	輪椅夢公園	橋頭輪椅夢公園																
中油遷廠特別條例	遷廠特別條例																	
鄧麗君紀念文物館	鄧麗君紀念館																	
震南鐵線公司	震南公司	震南鐵線	震南鐵線股份有限公司															
養護工程處養護大隊	養護大隊																	
橋頭地方法院	橋頭地院																	
竹林公園	橋頭竹林公園	橋頭區竹林公園																
九甲圍義山宮	橋頭義山宮																	
橋頭區農會	橋頭農會																	
高雄市立圖書館橋頭分館	橋頭圖書館																	
台灣糖業博物館	橋頭糖業博物館																	
高雄燈會	燈會																	
烏山頂泥火山自然保留區	燕巢烏山頂泥火山自然保留區																	
燕巢區衛生掩埋場	燕巢區掩埋場																	
義大醫院	燕巢區義大醫院																	
燕巢區農會	燕巢農會																	
高雄學園線	燕巢線																	
燕巢動物保護關愛園區	燕巢關愛園區																	
興田社區活動中心	興田活動中心																	
興達發電廠	興達火力發電廠	興達電廠																
葫蘆雕刻藝術館	雕刻藝術館																	
朱一貴	鴨母王																	
甲仙龍鳳寺	龍鳳寺																	
龍潭購地案	龍潭案																	
勵馨社會福利事業基金會	勵馨社福基金會	勵馨基金會																
南寮魚港	彌陀南寮漁港																	
南寮海岸光廊	彌陀海岸光廊																	
高雄市立圖書館彌陀分館	彌陀圖書館																	
彌壽宮	彌陀彌壽宮																	
營建署南區工程處	營建署南工處																	
環保媽媽環境保護基金會	環保媽媽基金會																	
環境保護署環境監測及資訊處	環保署監資處																	
環境保護署廢棄物管理處	環保署廢管處																	
環境保護署環境督察總隊	環保署環境督察總隊																	
環境保護署環境檢驗所	環保署環檢所	環檢所																
地球公民基金會	環保團體地球公民基金會	環團地球公民基金會																
環境品質文教基金會	環品基金會																	
環境影響評估	環評																	
環境影響評估審查委員會	環評委員會	環境影響評估委員會																
環境影響評估法	環評法																	
高雄市環境工程技師公會	環境工程技師協會																	
法務部矯正署	矯正署																	
總統府南部辦公室	總統府南辦																	
總統府國家安全會議	總統府國安會																	
聯合國氣候變遷綱要公約	聯合國氣候變化綱要公約																	
聯合國糧食及農業組織	聯合國農糧組織																	
聯合國環境署	聯合國環境規劃署																	
中華社會福利聯合勸募協會	聯合勸募協會																	
聯發科技	聯發科																	
聯華電子	聯電																	
旗津臨水宮	臨水宮																	
高雄臨海工業區服務中心	臨海工業管理中心																	
臨海污水處理廠	臨海污水廠																	
薛家古厝	薛氏古厝																	
職業安全衛生法	職安法																	
中華職業棒球大聯盟	職棒聯盟																	
舊振南餅店	舊振南																	
舊振南漢餅文化館	舊振南觀光工廠																	
舊鐵橋濕地生態公園	舊鐵橋濕地公園																	
仁壽宮	藍田里仁壽宮																	
高雄市第一殯儀館	覆鼎金第一殯儀館																	
左營豐穀宮	豐谷宮	豐穀宮																
醫療發展基金	醫發基金																	
衛生福利部醫事審議委員會	醫審會																	
鎮興橋	鎮川橋																	
世界貿易中心	雙子星世貿大樓																	
鳳山雙慈亭	雙慈亭																	
離島建設條例	離島條例																	
中華民國獸醫師公會全國聯合會	獸醫師全聯會																	
藤枝國家森林遊樂區	藤枝森林遊樂區																	
潭美颱風	譚美颱風																	
高雄關帝廟	關帝廟																	
高雄願景館	願景館																	
公益勸募條例	勸募條例																	
寶山二集團櫻花公園	寶山里櫻花公園	櫻花公園																
汕尾爐濟殿	爐濟殿	爐濟殿關聖帝君																
蘇迪勒颱風	蘇迪勒颱風事件	蘇迪樂颱風																
警政署刑事警察局	警政署刑事局																	
警察勤務條例	警勤條例																	
警察局少年警察隊	警察局少年隊																	
警察局交通警察大隊	警察局交通大隊																	
饒慶鈴	饒慶玲																	
政黨及其附隨組織不當取得財產處理條例	黨產條例	黨產處理條例																
高雄市國際蘭馨交流協會	蘭馨會																	
交通部鐵路改建工程局	鐵工局	鐵改局	鐵路改建工程局															
鐵路工程局南部工程處	鐵工局南工處	鐵工局南部工程處																
交通部鐵道局	鐵道局																	
交通部鐵道局南部工程處	鐵道局南工處																	
聽障奧林匹克運動會	聽奧																	
教育部體育署	體育署																	
中華民國體育運動總會	體育總會																	
高雄靈糧堂	靈糧堂																	
鹽水港溪濕地	鹽水港濕地																	
永安濕地生態教育中心	鹽田里濕地生態中心																	
永安鹽田濕地	鹽田濕地																	
鹽埕第一公有市場	鹽埕公有市場																	
鹽埕非營利幼兒園	鹽埕幼兒園																	
高雄市文武聖殿	鹽埕區文武聖殿																	
行政院觀光發展推動委員會	觀光發展推動委員會																	
觀光暨教育交流合作備忘錄	觀光暨交流合作備忘錄																	
內門紫竹寺	觀亭紫竹寺																	
高雄市觀音慈善會	觀音慈善會																	
